Year,Region,Host,Athletes,Events,Gold,Silver,Bronze,Medals
1896,Greece,1,102,39,10,17,17,44
1896,USA,0,14,16,11,6,2,19
1896,Germany,0,19,27,7,5,2,14
1896,France,0,12,18,5,4,2,11
1896,UK,0,10,19,3,3,3,9
1896,Denmark,0,3,12,1,2,3,6
1896,Hungary,0,7,14,2,1,3,6
1896,Austria,0,3,8,2,1,2,5
1896,Australia,0,1,5,2,0,1,3
1896,Switzerland,0,3,5,1,2,0,3
1896,Italy,0,1,1,0,0,0,0
1896,Sweden,0,1,5,0,0,0,0
1900,France,1,716,81,28,40,34,102
1900,USA,0,75,41,21,16,17,54
1900,UK,0,104,39,19,11,12,42
1900,Belgium,0,64,31,6,7,5,18
1900,Switzerland,0,18,14,6,2,1,9
1900,Germany,0,76,27,4,3,1,8
1900,Denmark,0,13,14,2,3,2,7
1900,Netherlands,0,35,18,1,2,4,7
1900,Australia,0,2,6,3,0,3,6
1900,Austria,0,16,17,0,3,3,6
1900,Hungary,0,18,21,1,2,2,5
1900,Italy,0,23,17,3,2,0,5
1900,Norway,0,7,9,0,2,3,5
1900,Czech Republic,0,7,9,0,1,2,3
1900,Canada,0,4,5,1,0,1,2
1900,Cuba,0,1,2,1,1,0,2
1900,India,0,1,5,0,2,0,2
1900,Sweden,0,10,16,1,0,1,2
1900,Colombia,0,1,1,0,1,0,1
1900,Haiti,0,3,4,1,0,0,1
1900,Luxembourg,0,1,1,1,0,0,1
1900,Mexico,0,3,1,0,0,1,1
1900,New Zealand,0,1,1,1,0,0,1
1900,Spain,0,9,7,1,0,0,1
1900,Argentina,0,1,1,0,0,0,0
1900,Brazil,0,1,3,0,0,0,0
1900,Greece,0,3,3,0,0,0,0
1900,Iran,0,1,1,0,0,0,0
1900,Peru,0,1,2,0,0,0,0
1900,Romania,0,1,1,0,0,0,0
1900,Russia,0,4,3,0,0,0,0
1904,USA,1,524,95,76,79,75,230
1904,Germany,0,22,25,4,5,7,16
1904,Canada,0,57,16,4,1,1,6
1904,Australia,0,2,6,0,3,1,4
1904,Austria,0,2,7,2,1,1,4
1904,Cuba,0,3,5,4,0,0,4
1904,Hungary,0,4,9,2,1,1,4
1904,Switzerland,0,3,4,1,0,2,3
1904,France,0,1,2,0,2,0,2
1904,Greece,0,14,5,1,0,1,2
1904,Norway,0,3,6,2,0,0,2
1904,UK,0,6,4,1,1,0,2
1904,Italy,0,1,1,0,0,0,0
1904,South Africa,0,8,2,0,0,0,0
1906,France,0,56,51,15,10,16,41
1906,Greece,1,320,70,8,14,13,35
1906,UK,0,48,42,8,12,5,25
1906,USA,0,38,28,12,5,6,23
1906,Italy,0,76,37,7,6,3,16
1906,Germany,0,49,41,4,6,4,14
1906,Sweden,0,39,37,2,5,7,14
1906,Hungary,0,35,41,2,5,3,10
1906,Austria,0,31,46,3,3,3,9
1906,Switzerland,0,9,14,4,3,1,8
1906,Belgium,0,16,22,2,2,3,7
1906,Denmark,0,49,24,3,2,1,6
1906,Finland,0,4,11,2,1,1,4
1906,Australia,0,4,9,0,0,3,3
1906,Netherlands,0,16,8,0,1,2,3
1906,Canada,0,3,4,1,1,0,2
1906,Czech Republic,0,13,22,0,0,2,2
1906,Norway,0,32,12,1,1,0,2
1906,Egypt,0,2,5,0,0,0,0
1906,Turkey,0,1,2,0,0,0,0
1908,UK,1,735,108,56,50,37,143
1908,USA,0,122,52,22,12,12,46
1908,Sweden,0,168,67,8,6,11,25
1908,France,0,208,54,5,5,9,19
1908,Canada,0,87,42,3,3,10,16
1908,Germany,0,82,41,3,5,5,13
1908,Hungary,0,65,37,3,4,2,9
1908,Belgium,0,70,33,1,5,2,8
1908,Norway,0,69,23,2,3,3,8
1908,Australia,0,30,20,1,2,2,5
1908,Denmark,0,78,27,0,2,3,5
1908,Finland,0,62,23,1,1,3,5
1908,Greece,0,20,25,0,3,1,4
1908,Italy,0,66,30,2,2,0,4
1908,Russia,0,6,7,1,2,0,3
1908,Czech Republic,0,19,15,0,0,2,2
1908,Netherlands,0,113,45,0,0,2,2
1908,South Africa,0,14,15,1,1,0,2
1908,Austria,0,7,10,0,0,1,1
1908,Argentina,0,1,1,0,0,0,0
1908,Iceland,0,1,1,0,0,0,0
1908,Switzerland,0,1,1,0,0,0,0
1912,Sweden,1,444,95,24,24,17,65
1912,USA,0,174,68,26,18,19,63
1912,UK,0,274,79,10,15,16,41
1912,Finland,0,164,49,9,8,9,26
1912,Germany,0,185,69,6,13,7,26
1912,France,0,119,66,7,5,3,15
1912,Denmark,0,152,46,1,6,5,12
1912,Norway,0,190,58,4,1,5,10
1912,Canada,0,37,30,3,2,3,8
1912,Hungary,0,121,52,3,2,3,8
1912,Italy,0,66,36,5,1,2,8
1912,Australia,0,25,17,2,2,3,7
1912,Belgium,0,36,23,2,1,3,6
1912,South Africa,0,21,21,4,2,0,6
1912,Russia,0,159,62,0,2,3,5
1912,Austria,0,85,46,0,2,2,4
1912,Netherlands,0,33,14,0,0,3,3
1912,Greece,0,22,25,1,0,1,2
1912,Switzerland,0,7,3,1,0,0,1
1912,Chile,0,14,16,0,0,0,0
1912,Czech Republic,0,43,26,0,0,0,0
1912,Iceland,0,2,2,0,0,0,0
1912,Japan,0,2,4,0,0,0,0
1912,Luxembourg,0,21,6,0,0,0,0
1912,Poland,0,1,1,0,0,0,0
1912,Portugal,0,6,8,0,0,0,0
1912,Serbia,0,2,2,0,0,0,0
1912,Turkey,0,2,7,0,0,0,0
1920,USA,0,288,113,41,27,27,95
1920,Sweden,0,259,100,19,20,25,64
1920,UK,0,234,84,14,16,13,43
1920,Belgium,1,336,121,16,12,14,42
1920,France,0,304,113,9,20,13,42
1920,Finland,0,63,51,15,10,9,34
1920,Norway,0,193,72,10,10,9,29
1920,Italy,0,174,79,14,6,5,25
1920,Denmark,0,154,66,3,9,1,13
1920,Netherlands,0,130,58,4,2,5,11
1920,Switzerland,0,77,45,2,2,7,11
1920,South Africa,0,39,34,3,4,3,10
1920,Canada,0,52,39,3,3,3,9
1920,Australia,0,13,19,0,2,1,3
1920,Brazil,0,19,10,1,1,1,3
1920,Estonia,0,14,19,1,2,0,3
1920,Czech Republic,0,119,53,0,0,2,2
1920,Japan,0,15,15,0,2,0,2
1920,Spain,0,58,29,0,2,0,2
1920,Greece,0,47,34,0,1,0,1
1920,Luxembourg,0,25,18,0,1,0,1
1920,New Zealand,0,4,6,0,0,1,1
1920,Argentina,0,1,1,0,0,0,0
1920,Chile,0,2,2,0,0,0,0
1920,Egypt,0,18,11,0,0,0,0
1920,India,0,5,6,0,0,0,0
1920,Monaco,0,4,6,0,0,0,0
1920,Portugal,0,13,7,0,0,0,0
1920,Serbia,0,15,1,0,0,0,0
1924,USA,0,299,108,45,27,27,99
1924,France,1,401,128,14,14,12,40
1924,Finland,0,121,69,14,13,10,37
1924,UK,0,267,115,9,14,12,35
1924,Sweden,0,159,84,4,13,12,29
1924,Switzerland,0,141,74,7,8,10,25
1924,Italy,0,200,93,8,3,5,16
1924,Belgium,0,172,82,3,7,3,13
1924,Denmark,0,89,60,2,6,3,11
1924,Netherlands,0,177,81,4,1,6,11
1924,Czech Republic,0,133,75,1,4,5,10
1924,Hungary,0,89,54,2,4,4,10
1924,Norway,0,62,43,5,2,3,10
1924,Argentina,0,77,39,1,3,2,6
1924,Australia,0,36,31,3,1,2,6
1924,Estonia,0,37,26,1,1,4,6
1924,Austria,0,49,27,0,3,1,4
1924,Canada,0,65,39,0,3,1,4
1924,South Africa,0,30,25,1,1,1,3
1924,Ireland,0,48,29,0,1,1,2
1924,Luxembourg,0,48,35,1,1,0,2
1924,Poland,0,65,38,0,1,1,2
1924,Serbia,0,42,27,2,0,0,2
1924,Greece,0,39,37,1,0,0,1
1924,Haiti,0,8,9,0,0,1,1
1924,Japan,0,19,21,0,0,1,1
1924,Monaco,0,7,6,0,0,1,1
1924,New Zealand,0,4,6,0,0,1,1
1924,Portugal,0,28,16,0,0,1,1
1924,Romania,0,35,7,0,0,1,1
1924,Uruguay,0,26,11,1,0,0,1
1924,Brazil,0,12,15,0,0,0,0
1924,Bulgaria,0,24,12,0,0,0,0
1924,Chile,0,13,12,0,0,0,0
1924,Cuba,0,9,3,0,0,0,0
1924,Ecuador,0,3,4,0,0,0,0
1924,Egypt,0,24,12,0,0,0,0
1924,India,0,13,13,0,0,0,0
1924,Latvia,0,36,23,0,0,0,0
1924,Lithuania,0,13,2,0,0,0,0
1924,Mexico,0,15,15,0,0,0,0
1924,Philippines,0,1,2,0,0,0,0
1924,Russia,0,3,2,0,0,0,0
1924,Spain,0,95,44,0,0,0,0
1924,Turkey,0,22,11,0,0,0,0
1928,USA,0,280,96,22,18,16,56
1928,Germany,0,294,95,11,9,19,39
1928,Finland,0,69,48,8,8,9,25
1928,France,0,255,112,7,12,6,25
1928,Sweden,0,100,66,7,6,12,25
1928,Netherlands,1,266,103,8,10,5,23
1928,UK,0,232,84,4,11,7,22
1928,Italy,0,174,81,7,6,7,20
1928,Switzerland,0,133,70,7,6,4,17
1928,Canada,0,69,49,4,4,7,15
1928,Hungary,0,109,63,5,5,0,10
1928,Czech Republic,0,69,51,2,5,2,9
1928,Denmark,0,91,55,3,2,4,9
1928,Argentina,0,81,40,3,3,1,7
1928,Poland,0,93,44,2,1,4,7
1928,Estonia,0,20,19,2,1,2,5
1928,Japan,0,40,31,2,2,1,5
1928,Serbia,0,34,21,1,1,3,5
1928,Australia,0,18,26,1,2,1,4
1928,Austria,0,73,39,3,0,1,4
1928,Egypt,0,32,14,2,1,1,4
1928,Norway,0,52,42,1,2,1,4
1928,Belgium,0,187,90,0,1,2,3
1928,South Africa,0,24,25,1,0,2,3
1928,Chile,0,38,22,0,1,0,1
1928,Haiti,0,2,3,0,1,0,1
1928,India,0,21,10,1,0,0,1
1928,Ireland,0,38,27,1,0,0,1
1928,Luxembourg,0,48,31,1,0,0,1
1928,New Zealand,0,9,12,1,0,0,1
1928,Philippines,0,4,6,0,0,1,1
1928,Portugal,0,32,14,0,0,1,1
1928,Spain,0,80,34,1,0,0,1
1928,Uruguay,0,17,1,1,0,0,1
1928,Bulgaria,0,5,5,0,0,0,0
1928,Cuba,0,1,1,0,0,0,0
1928,Greece,0,23,26,0,0,0,0
1928,Latvia,0,17,14,0,0,0,0
1928,Lithuania,0,12,10,0,0,0,0
1928,Malta,0,9,1,0,0,0,0
1928,Mexico,0,30,18,0,0,0,0
1928,Monaco,0,10,8,0,0,0,0
1928,Panama,0,1,2,0,0,0,0
1928,Romania,0,21,16,0,0,0,0
1928,Turkey,0,31,17,0,0,0,0
1928,Zimbabwe,0,2,2,0,0,0,0
1932,USA,1,474,122,44,36,30,110
1932,Italy,0,112,61,12,12,12,36
1932,Finland,0,40,36,5,8,12,25
1932,Germany,0,145,67,5,12,7,24
1932,Sweden,0,81,51,10,5,9,24
1932,France,0,103,57,11,5,4,20
1932,Japan,0,157,66,7,7,4,18
1932,UK,0,107,50,5,7,5,17
1932,Canada,0,102,69,2,5,9,16
1932,Hungary,0,58,39,6,5,5,16
1932,Poland,0,51,21,3,2,4,9
1932,Denmark,0,43,34,0,5,3,8
1932,Netherlands,0,46,29,2,5,1,8
1932,Czech Republic,0,25,15,1,3,2,6
1932,Australia,0,13,17,3,1,1,5
1932,Austria,0,19,14,1,1,3,5
1932,South Africa,0,12,18,2,0,3,5
1932,Argentina,0,33,30,3,1,0,4
1932,Philippines,0,8,7,0,0,3,3
1932,Ireland,0,16,10,2,0,0,2
1932,Mexico,0,73,52,0,2,0,2
1932,Belgium,0,36,10,0,0,1,1
1932,India,0,19,8,1,0,0,1
1932,Latvia,0,5,4,0,1,0,1
1932,New Zealand,0,21,15,0,1,0,1
1932,Spain,0,7,4,0,0,1,1
1932,Switzerland,0,7,9,0,1,0,1
1932,Uruguay,0,2,2,0,0,1,1
1932,Brazil,0,59,28,0,0,0,0
1932,Bulgaria,0,2,1,0,0,0,0
1932,China,0,1,2,0,0,0,0
1932,Colombia,0,2,2,0,0,0,0
1932,Cuba,0,3,1,0,0,0,0
1932,El Salvador,0,1,1,0,0,0,0
1932,Estonia,0,2,3,0,0,0,0
1932,Greece,0,10,12,0,0,0,0
1932,Guatemala,0,1,1,0,0,0,0
1932,Haiti,0,3,3,0,0,0,0
1932,Luxembourg,0,3,3,0,0,0,0
1932,Monaco,0,1,1,0,0,0,0
1932,Norway,0,7,8,0,0,0,0
1932,Peru,0,2,1,0,0,0,0
1932,Portugal,0,6,4,0,0,0,0
1932,Romania,0,1,1,0,0,0,0
1932,Serbia,0,1,1,0,0,0,0
1932,Turkey,0,1,1,0,0,0,0
1932,Venezuela,0,1,1,0,0,0,0
1936,Germany,1,433,143,38,31,32,101
1936,USA,0,359,127,24,21,12,57
1936,Italy,0,244,99,9,13,5,27
1936,Sweden,0,171,84,6,5,10,21
1936,Finland,0,108,70,8,6,6,20
1936,Japan,0,220,79,6,4,10,20
1936,France,0,201,100,7,6,6,19
1936,Switzerland,0,190,102,4,9,5,18
1936,Austria,0,234,105,5,7,5,17
1936,Netherlands,0,165,75,6,4,7,17
1936,Hungary,0,216,104,10,1,5,16
1936,UK,0,208,91,4,7,3,14
1936,Canada,0,97,69,1,3,5,9
1936,Czech Republic,0,189,102,3,5,1,9
1936,Poland,0,144,55,0,4,5,9
1936,Argentina,0,51,31,2,2,3,7
1936,Estonia,0,33,29,2,2,3,7
1936,Norway,0,70,43,1,3,2,6
1936,Denmark,0,121,71,0,2,3,5
1936,Egypt,0,53,30,2,1,2,5
1936,Belgium,0,150,72,0,0,3,3
1936,Mexico,0,32,14,0,0,3,3
1936,Latvia,0,29,16,0,1,1,2
1936,Turkey,0,48,26,1,0,1,2
1936,Australia,0,32,26,0,0,1,1
1936,India,0,27,12,1,0,0,1
1936,New Zealand,0,7,9,1,0,0,1
1936,Philippines,0,28,20,0,0,1,1
1936,Portugal,0,19,10,0,0,1,1
1936,Romania,0,54,33,0,1,0,1
1936,Serbia,0,93,59,0,1,0,1
1936,South Africa,0,32,27,0,1,0,1
1936,Afghanistan,0,15,4,0,0,0,0
1936,Bermuda,0,5,4,0,0,0,0
1936,Boliva,0,2,2,0,0,0,0
1936,Brazil,0,73,37,0,0,0,0
1936,Bulgaria,0,26,22,0,0,0,0
1936,Chile,0,40,27,0,0,0,0
1936,China,0,54,27,0,0,0,0
1936,Colombia,0,5,5,0,0,0,0
1936,Costa Rica,0,1,1,0,0,0,0
1936,Greece,0,41,34,0,0,0,0
1936,Iceland,0,12,6,0,0,0,0
1936,Liechtenstein,0,6,5,0,0,0,0
1936,Luxembourg,0,49,37,0,0,0,0
1936,Malta,0,11,2,0,0,0,0
1936,Monaco,0,8,5,0,0,0,0
1936,Peru,0,40,16,0,0,0,0
1936,Uruguay,0,37,15,0,0,0,0
1948,USA,0,300,126,38,27,19,84
1948,Sweden,0,181,100,17,11,18,46
1948,France,0,316,135,11,6,15,32
1948,Italy,0,215,89,9,12,10,31
1948,Hungary,0,128,76,10,5,12,27
1948,UK,1,407,139,4,16,7,27
1948,Denmark,0,162,83,5,8,9,22
1948,Finland,0,129,84,8,8,6,22
1948,Switzerland,0,186,98,5,12,5,22
1948,Netherlands,0,149,74,5,2,9,16
1948,Australia,0,75,52,2,6,5,13
1948,Turkey,0,58,42,6,4,2,12
1948,Czech Republic,0,87,57,6,2,3,11
1948,Austria,0,148,79,2,2,4,8
1948,Argentina,0,199,101,3,3,1,7
1948,Belgium,0,152,77,2,2,3,7
1948,Norway,0,81,50,1,3,3,7
1948,South Africa,0,35,34,2,2,2,6
1948,Egypt,0,85,53,2,2,1,5
1948,Mexico,0,88,57,2,1,2,5
1948,Canada,0,127,83,0,2,2,4
1948,Jamaica,0,13,14,1,2,0,3
1948,Panama,0,1,2,0,0,2,2
1948,Poland,0,38,28,1,0,1,2
1948,Portugal,0,48,22,0,1,1,2
1948,Serbia,0,90,35,0,2,0,2
1948,South Korea,0,46,24,0,0,2,2
1948,Uruguay,0,61,32,0,1,1,2
1948,Brazil,0,70,41,0,0,1,1
1948,Cuba,0,53,31,0,1,0,1
1948,India,0,79,39,1,0,0,1
1948,Iran,0,36,23,0,0,1,1
1948,Ireland,0,73,34,0,0,1,1
1948,Peru,0,41,26,1,0,0,1
1948,Puerto Rico,0,9,8,0,0,1,1
1948,Spain,0,65,37,0,1,0,1
1948,Sri Lanka,0,7,9,0,1,0,1
1948,Trinidad,0,5,9,0,1,0,1
1948,Afghanistan,0,25,2,0,0,0,0
1948,Bermuda,0,12,13,0,0,0,0
1948,Chile,0,54,31,0,0,0,0
1948,China,0,31,12,0,0,0,0
1948,Colombia,0,6,6,0,0,0,0
1948,Greece,0,61,44,0,0,0,0
1948,Guyana,0,4,7,0,0,0,0
1948,Iceland,0,20,18,0,0,0,0
1948,Iraq,0,11,4,0,0,0,0
1948,Lebanon,0,8,9,0,0,0,0
1948,Liechtenstein,0,2,1,0,0,0,0
1948,Luxembourg,0,45,32,0,0,0,0
1948,Malta,0,1,1,0,0,0,0
1948,Monaco,0,4,2,0,0,0,0
1948,Myanmar,0,4,5,0,0,0,0
1948,New Zealand,0,7,8,0,0,0,0
1948,Pakistan,0,35,20,0,0,0,0
1948,Philippines,0,26,18,0,0,0,0
1948,Singapore,0,1,1,0,0,0,0
1948,Syria,0,1,1,0,0,0,0
1948,Venezuela,0,1,2,0,0,0,0
1952,USA,0,286,133,40,19,17,76
1952,Russia,0,295,141,22,29,19,70
1952,Hungary,0,188,107,16,10,16,42
1952,Sweden,0,206,124,12,13,10,35
1952,Germany,0,241,128,0,7,17,24
1952,Finland,1,258,139,6,3,13,22
1952,Italy,0,231,114,8,9,4,21
1952,France,0,245,131,6,6,6,18
1952,Switzerland,0,157,96,2,6,6,14
1952,Czech Republic,0,99,70,7,3,3,13
1952,Australia,0,81,67,6,2,3,11
1952,UK,0,257,127,1,2,8,11
1952,South Africa,0,64,59,2,4,4,10
1952,Japan,0,69,60,1,6,1,8
1952,Iran,0,22,22,0,3,4,7
1952,Denmark,0,129,73,2,1,3,6
1952,Argentina,0,123,77,1,2,2,5
1952,Jamaica,0,8,10,2,3,0,5
1952,Netherlands,0,104,57,0,5,0,5
1952,Norway,0,102,72,3,2,0,5
1952,Belgium,0,135,74,2,2,0,4
1952,Poland,0,125,74,1,2,1,4
1952,Romania,0,114,67,1,1,2,4
1952,Brazil,0,97,51,1,0,2,3
1952,Canada,0,107,74,1,2,0,3
1952,New Zealand,0,14,14,1,0,2,3
1952,Serbia,0,87,48,1,2,0,3
1952,Turkey,0,51,31,2,0,1,3
1952,Austria,0,112,70,0,1,1,2
1952,Chile,0,59,33,0,2,0,2
1952,India,0,64,42,1,0,1,2
1952,Lebanon,0,9,8,0,1,1,2
1952,South Korea,0,19,16,0,0,2,2
1952,Trinidad,0,2,2,0,0,2,2
1952,Uruguay,0,32,16,0,0,2,2
1952,Bulgaria,0,63,34,0,0,1,1
1952,Egypt,0,106,65,0,0,1,1
1952,Ireland,0,19,18,0,1,0,1
1952,Luxembourg,0,44,32,1,0,0,1
1952,Mexico,0,64,35,0,1,0,1
1952,Portugal,0,71,45,0,0,1,1
1952,Spain,0,27,21,0,1,0,1
1952,Venezuela,0,38,37,0,0,1,1
1952,Bahamas,0,7,3,0,0,0,0
1952,Bermuda,0,6,6,0,0,0,0
1952,China,0,5,7,0,0,0,0
1952,Cuba,0,29,23,0,0,0,0
1952,Curacao,0,11,1,0,0,0,0
1952,Ghana,0,7,5,0,0,0,0
1952,Greece,0,48,24,0,0,0,0
1952,Guatemala,0,21,26,0,0,0,0
1952,Guyana,0,1,1,0,0,0,0
1952,Iceland,0,9,11,0,0,0,0
1952,Indonesia,0,3,3,0,0,0,0
1952,Israel,0,25,17,0,0,0,0
1952,Liechtenstein,0,2,1,0,0,0,0
1952,Monaco,0,8,6,0,0,0,0
1952,Myanmar,0,5,5,0,0,0,0
1952,Nigeria,0,9,5,0,0,0,0
1952,Pakistan,0,38,25,0,0,0,0
1952,Panama,0,1,1,0,0,0,0
1952,Philippines,0,25,14,0,0,0,0
1952,Puerto Rico,0,21,19,0,0,0,0
1952,Singapore,0,5,7,0,0,0,0
1952,Sri Lanka,0,5,7,0,0,0,0
1952,Thailand,0,8,7,0,0,0,0
1952,Vietnam,0,8,7,0,0,0,0
1956,Russia,0,281,141,37,29,32,98
1956,USA,0,305,144,32,25,17,74
1956,Australia,1,298,143,13,8,14,35
1956,Germany,0,167,100,6,13,7,26
1956,Hungary,0,111,82,9,10,7,26
1956,Italy,0,135,80,8,8,9,25
1956,UK,0,197,113,6,7,11,24
1956,Sweden,0,97,80,8,5,6,19
1956,Japan,0,112,72,4,10,3,17
1956,Finland,0,71,67,3,1,11,15
1956,France,0,145,101,4,4,6,14
1956,Romania,0,50,39,5,3,5,13
1956,Poland,0,64,48,1,4,4,9
1956,Turkey,0,19,20,3,2,2,7
1956,Canada,0,96,84,2,1,3,6
1956,Czech Republic,0,63,54,1,4,1,6
1956,Bulgaria,0,47,31,1,3,1,5
1956,Iran,0,17,17,2,2,1,5
1956,Ireland,0,18,17,1,1,3,5
1956,Chile,0,33,22,0,2,2,4
1956,Denmark,0,37,29,1,2,1,4
1956,South Africa,0,50,50,0,0,4,4
1956,Norway,0,22,18,1,0,2,3
1956,Serbia,0,35,16,0,3,0,3
1956,Argentina,0,35,32,0,1,1,2
1956,Austria,0,34,36,0,0,2,2
1956,Belgium,0,57,39,0,2,0,2
1956,Mexico,0,24,20,1,0,1,2
1956,New Zealand,0,51,28,2,0,0,2
1956,South Korea,0,35,23,0,1,1,2
1956,Bahamas,0,4,4,0,0,1,1
1956,Brazil,0,47,30,1,0,0,1
1956,Greece,0,13,13,0,0,1,1
1956,Iceland,0,2,2,0,1,0,1
1956,India,0,59,32,1,0,0,1
1956,Pakistan,0,54,43,0,1,0,1
1956,Switzerland,0,9,6,0,0,1,1
1956,Uruguay,0,21,8,0,0,1,1
1956,Afghanistan,0,12,1,0,0,0,0
1956,Bermuda,0,3,1,0,0,0,0
1956,Cambodia,0,2,1,0,0,0,0
1956,China,0,2,3,0,0,0,0
1956,Colombia,0,26,23,0,0,0,0
1956,Cuba,0,16,16,0,0,0,0
1956,Egypt,0,3,2,0,0,0,0
1956,Ethiopia,0,12,10,0,0,0,0
1956,Fiji,0,5,4,0,0,0,0
1956,Guyana,0,4,6,0,0,0,0
1956,Indonesia,0,22,11,0,0,0,0
1956,Israel,0,3,3,0,0,0,0
1956,Jamaica,0,6,6,0,0,0,0
1956,Kenya,0,25,10,0,0,0,0
1956,Liberia,0,4,6,0,0,0,0
1956,Luxembourg,0,11,22,0,0,0,0
1956,Malaysia,0,34,14,0,0,0,0
1956,Myanmar,0,11,11,0,0,0,0
1956,Netherlands,0,1,1,0,0,0,0
1956,Nigeria,0,10,6,0,0,0,0
1956,Peru,0,8,5,0,0,0,0
1956,Philippines,0,39,30,0,0,0,0
1956,Portugal,0,12,7,0,0,0,0
1956,Puerto Rico,0,10,9,0,0,0,0
1956,Singapore,0,49,13,0,0,0,0
1956,Spain,0,6,4,0,0,0,0
1956,Sri Lanka,0,3,3,0,0,0,0
1956,Taiwan,0,20,13,0,0,0,0
1956,Thailand,0,35,14,0,0,0,0
1956,Trinidad,0,6,7,0,0,0,0
1956,Uganda,0,3,5,0,0,0,0
1956,Venezuela,0,22,16,0,0,0,0
1956,Vietnam,0,6,4,0,0,0,0
1960,Russia,0,283,145,43,29,31,103
1960,USA,0,292,147,34,21,16,71
1960,Germany,0,293,148,12,19,11,42
1960,Italy,1,280,138,13,10,13,36
1960,Australia,0,189,122,8,8,6,22
1960,Hungary,0,183,107,6,8,7,21
1960,Poland,0,185,108,4,6,11,21
1960,UK,0,253,130,2,6,12,20
1960,Japan,0,161,96,4,7,7,18
1960,Romania,0,98,65,3,1,6,10
1960,Turkey,0,49,41,7,2,0,9
1960,Czech Republic,0,116,75,3,2,3,8
1960,Bulgaria,0,98,66,1,3,3,7
1960,Denmark,0,100,46,2,3,1,6
1960,Sweden,0,134,100,1,2,3,6
1960,Switzerland,0,149,90,0,3,3,6
1960,Finland,0,117,92,1,1,3,5
1960,France,0,238,120,0,2,3,5
1960,Belgium,0,101,64,0,2,2,4
1960,Iran,0,23,24,0,1,3,4
1960,Netherlands,0,110,54,0,1,2,3
1960,New Zealand,0,37,28,2,0,1,3
1960,South Africa,0,55,46,0,1,2,3
1960,Argentina,0,92,54,0,1,1,2
1960,Austria,0,103,81,1,1,0,2
1960,Brazil,0,72,35,0,0,2,2
1960,Pakistan,0,43,35,1,0,1,2
1960,Serbia,0,116,64,1,1,0,2
1960,Syria,0,74,34,0,1,1,2
1960,Trinidad,0,13,13,0,0,2,2
1960,Canada,0,85,77,0,1,0,1
1960,Ethiopia,0,10,8,1,0,0,1
1960,Ghana,0,13,12,0,1,0,1
1960,Greece,0,48,38,1,0,0,1
1960,India,0,45,20,0,1,0,1
1960,Iraq,0,21,23,0,0,1,1
1960,Mexico,0,69,55,0,0,1,1
1960,Morocco,0,47,45,0,1,0,1
1960,Norway,0,40,39,1,0,0,1
1960,Portugal,0,65,52,0,1,0,1
1960,Singapore,0,5,3,0,1,0,1
1960,Spain,0,144,83,0,0,1,1
1960,Taiwan,0,27,18,0,1,0,1
1960,Venezuela,0,36,26,0,0,1,1
1960,Afghanistan,0,12,13,0,0,0,0
1960,Bahamas,0,13,8,0,0,0,0
1960,Bermuda,0,9,4,0,0,0,0
1960,Chile,0,9,8,0,0,0,0
1960,China,0,4,3,0,0,0,0
1960,Colombia,0,16,13,0,0,0,0
1960,Cuba,0,12,15,0,0,0,0
1960,Curacao,0,5,4,0,0,0,0
1960,Fiji,0,2,3,0,0,0,0
1960,Guyana,0,5,6,0,0,0,0
1960,Haiti,0,1,1,0,0,0,0
1960,Iceland,0,9,11,0,0,0,0
1960,Indonesia,0,22,17,0,0,0,0
1960,Ireland,0,49,39,0,0,0,0
1960,Israel,0,23,28,0,0,0,0
1960,Kenya,0,27,13,0,0,0,0
1960,Lebanon,0,19,15,0,0,0,0
1960,Liberia,0,4,5,0,0,0,0
1960,Liechtenstein,0,5,6,0,0,0,0
1960,Luxembourg,0,52,48,0,0,0,0
1960,Malaysia,0,9,11,0,0,0,0
1960,Malta,0,10,6,0,0,0,0
1960,Monaco,0,11,6,0,0,0,0
1960,Myanmar,0,10,9,0,0,0,0
1960,Nigeria,0,12,12,0,0,0,0
1960,Panama,0,6,4,0,0,0,0
1960,Peru,0,31,8,0,0,0,0
1960,Philippines,0,40,27,0,0,0,0
1960,Puerto Rico,0,27,13,0,0,0,0
1960,San Marino,0,9,5,0,0,0,0
1960,South Korea,0,35,38,0,0,0,0
1960,Sri Lanka,0,5,5,0,0,0,0
1960,Sudan,0,10,10,0,0,0,0
1960,Thailand,0,20,16,0,0,0,0
1960,Tunisia,0,42,22,0,0,0,0
1960,Uganda,0,10,11,0,0,0,0
1960,Uruguay,0,34,15,0,0,0,0
1960,Vietnam,0,3,5,0,0,0,0
1960,Zimbabwe,0,14,17,0,0,0,0
1964,Russia,0,317,154,30,30,33,93
1964,USA,0,346,159,36,26,28,90
1964,Germany,0,337,159,10,22,18,50
1964,Japan,1,328,155,16,5,8,29
1964,Italy,0,167,91,10,10,7,27
1964,Poland,0,140,87,7,6,10,23
1964,Hungary,0,182,111,10,7,5,22
1964,Australia,0,243,133,6,2,10,18
1964,UK,0,204,124,4,12,2,18
1964,France,0,138,89,1,8,6,15
1964,Czech Republic,0,104,64,5,6,3,14
1964,Romania,0,138,76,2,4,6,12
1964,Bulgaria,0,63,56,3,5,2,10
1964,Netherlands,0,125,57,2,4,4,10
1964,Sweden,0,94,72,2,2,4,8
1964,Denmark,0,60,40,2,1,3,6
1964,Turkey,0,23,24,2,3,1,6
1964,Finland,0,89,64,3,0,2,5
1964,New Zealand,0,64,35,3,0,2,5
1964,Serbia,0,75,32,2,1,2,5
1964,Canada,0,115,92,1,2,1,4
1964,Switzerland,0,66,51,1,2,1,4
1964,Belgium,0,61,36,2,0,1,3
1964,South Korea,0,153,93,0,2,1,3
1964,Trinidad,0,13,10,0,1,2,3
1964,Iran,0,62,58,0,0,2,2
1964,Tunisia,0,9,9,0,1,1,2
1964,Argentina,0,102,78,0,1,0,1
1964,Bahamas,0,11,6,1,0,0,1
1964,Brazil,0,61,17,0,0,1,1
1964,Cuba,0,27,24,0,1,0,1
1964,Ethiopia,0,12,11,1,0,0,1
1964,Ghana,0,33,18,0,0,1,1
1964,India,0,52,42,1,0,0,1
1964,Ireland,0,25,23,0,0,1,1
1964,Kenya,0,37,21,0,0,1,1
1964,Mexico,0,94,58,0,0,1,1
1964,Nigeria,0,18,12,0,0,1,1
1964,Pakistan,0,41,29,0,1,0,1
1964,Philippines,0,47,45,0,1,0,1
1964,Uruguay,0,23,8,0,0,1,1
1964,Afghanistan,0,8,8,0,0,0,0
1964,Algeria,0,1,7,0,0,0,0
1964,Austria,0,56,54,0,0,0,0
1964,Bermuda,0,4,2,0,0,0,0
1964,Boliva,0,1,1,0,0,0,0
1964,Cambodia,0,13,10,0,0,0,0
1964,Cameroon,0,1,2,0,0,0,0
1964,Chad,0,2,2,0,0,0,0
1964,Chile,0,14,13,0,0,0,0
1964,China,0,39,24,0,0,0,0
1964,Colombia,0,20,19,0,0,0,0
1964,Costa Rica,0,2,1,0,0,0,0
1964,Curacao,0,4,4,0,0,0,0
1964,Dominican Republic,0,1,1,0,0,0,0
1964,Egypt,0,73,35,0,0,0,0
1964,Greece,0,18,16,0,0,0,0
1964,Guyana,0,1,1,0,0,0,0
1964,Iceland,0,4,5,0,0,0,0
1964,Iraq,0,13,14,0,0,0,0
1964,Israel,0,10,12,0,0,0,0
1964,Ivory Coast,0,9,10,0,0,0,0
1964,Jamaica,0,21,16,0,0,0,0
1964,Lebanon,0,5,3,0,0,0,0
1964,Liberia,0,1,2,0,0,0,0
1964,Liechtenstein,0,2,3,0,0,0,0
1964,Luxembourg,0,12,18,0,0,0,0
1964,Madagascar,0,3,4,0,0,0,0
1964,Malaysia,0,61,48,0,0,0,0
1964,Mali,0,2,2,0,0,0,0
1964,Monaco,0,1,1,0,0,0,0
1964,Mongolia,0,21,29,0,0,0,0
1964,Morocco,0,20,10,0,0,0,0
1964,Myanmar,0,11,11,0,0,0,0
1964,Nepal,0,6,5,0,0,0,0
1964,Niger,0,1,1,0,0,0,0
1964,Norway,0,26,23,0,0,0,0
1964,Panama,0,10,10,0,0,0,0
1964,Peru,0,31,19,0,0,0,0
1964,Portugal,0,20,20,0,0,0,0
1964,Puerto Rico,0,32,29,0,0,0,0
1964,Republic of Congo,0,2,2,0,0,0,0
1964,Senegal,0,12,7,0,0,0,0
1964,Spain,0,51,35,0,0,0,0
1964,Sri Lanka,0,6,6,0,0,0,0
1964,Taiwan,0,40,46,0,0,0,0
1964,Tanzania,0,4,4,0,0,0,0
1964,Thailand,0,54,41,0,0,0,0
1964,Uganda,0,13,14,0,0,0,0
1964,Venezuela,0,16,16,0,0,0,0
1964,Vietnam,0,16,14,0,0,0,0
1964,Zambia,0,12,13,0,0,0,0
1964,Zimbabwe,0,29,15,0,0,0,0
1968,USA,0,357,167,45,28,34,107
1968,Russia,0,312,164,29,32,30,91
1968,Germany,0,499,166,14,20,17,51
1968,Hungary,0,166,116,10,10,12,32
1968,Japan,0,171,97,11,7,7,25
1968,Poland,0,177,112,5,2,11,18
1968,Australia,0,128,105,5,7,5,17
1968,Italy,0,167,103,3,4,9,16
1968,France,0,200,107,7,3,5,15
1968,Romania,0,82,64,4,6,5,15
1968,Czech Republic,0,121,66,7,2,4,13
1968,UK,0,225,133,5,5,3,13
1968,Bulgaria,0,112,69,2,4,3,9
1968,Kenya,0,39,22,3,4,2,9
1968,Mexico,1,274,146,3,3,3,9
1968,Denmark,0,64,53,1,4,3,8
1968,Serbia,0,69,54,3,3,2,8
1968,Netherlands,0,107,52,3,3,1,7
1968,Canada,0,139,124,1,3,1,5
1968,Iran,0,14,14,2,1,2,5
1968,Switzerland,0,85,68,0,1,4,5
1968,Austria,0,43,37,0,2,2,4
1968,Cuba,0,115,78,0,4,0,4
1968,Finland,0,66,61,1,2,1,4
1968,Mongolia,0,16,26,0,1,3,4
1968,Sweden,0,100,95,2,1,1,4
1968,Brazil,0,76,27,0,1,2,3
1968,New Zealand,0,52,26,1,0,2,3
1968,Argentina,0,89,60,0,0,2,2
1968,Belgium,0,82,55,0,1,1,2
1968,Ethiopia,0,18,13,1,1,0,2
1968,Norway,0,46,36,1,1,0,2
1968,South Korea,0,54,43,0,1,1,2
1968,Tunisia,0,7,7,1,0,1,2
1968,Turkey,0,29,29,2,0,0,2
1968,Uganda,0,11,14,0,1,1,2
1968,Cameroon,0,5,5,0,1,0,1
1968,Greece,0,44,27,0,0,1,1
1968,India,0,23,11,0,0,1,1
1968,Jamaica,0,25,21,0,1,0,1
1968,Pakistan,0,15,3,1,0,0,1
1968,Taiwan,0,43,57,0,0,1,1
1968,Venezuela,0,23,17,1,0,0,1
1968,Afghanistan,0,5,5,0,0,0,0
1968,Algeria,0,3,9,0,0,0,0
1968,Bahamas,0,16,12,0,0,0,0
1968,Barbados,0,9,10,0,0,0,0
1968,Belize,0,7,6,0,0,0,0
1968,Bermuda,0,6,4,0,0,0,0
1968,Boliva,0,4,3,0,0,0,0
1968,Central African Republic,0,1,1,0,0,0,0
1968,Chad,0,3,3,0,0,0,0
1968,Chile,0,21,19,0,0,0,0
1968,China,0,11,12,0,0,0,0
1968,Colombia,0,43,33,0,0,0,0
1968,Costa Rica,0,18,18,0,0,0,0
1968,Curacao,0,5,4,0,0,0,0
1968,Democratic Republic of the Congo,0,5,2,0,0,0,0
1968,Dominican Republic,0,18,16,0,0,0,0
1968,Ecuador,0,15,21,0,0,0,0
1968,Egypt,0,30,18,0,0,0,0
1968,El Salvador,0,60,48,0,0,0,0
1968,Fiji,0,1,1,0,0,0,0
1968,Ghana,0,31,18,0,0,0,0
1968,Guatemala,0,48,37,0,0,0,0
1968,Guinea,0,15,1,0,0,0,0
1968,Guyana,0,5,6,0,0,0,0
1968,Honduras,0,6,4,0,0,0,0
1968,Iceland,0,8,15,0,0,0,0
1968,Indonesia,0,6,5,0,0,0,0
1968,Iraq,0,3,4,0,0,0,0
1968,Ireland,0,31,32,0,0,0,0
1968,Israel,0,29,20,0,0,0,0
1968,Ivory Coast,0,10,7,0,0,0,0
1968,Kuwait,0,2,1,0,0,0,0
1968,Lebanon,0,11,13,0,0,0,0
1968,Libya,0,1,1,0,0,0,0
1968,Liechtenstein,0,2,3,0,0,0,0
1968,Luxembourg,0,5,7,0,0,0,0
1968,Madagascar,0,4,6,0,0,0,0
1968,Malaysia,0,31,14,0,0,0,0
1968,Mali,0,2,2,0,0,0,0
1968,Malta,0,1,1,0,0,0,0
1968,Monaco,0,2,1,0,0,0,0
1968,Morocco,0,25,14,0,0,0,0
1968,Myanmar,0,4,3,0,0,0,0
1968,Nicaragua,0,11,15,0,0,0,0
1968,Niger,0,2,2,0,0,0,0
1968,Nigeria,0,36,18,0,0,0,0
1968,Panama,0,16,5,0,0,0,0
1968,Paraguay,0,1,1,0,0,0,0
1968,Peru,0,28,21,0,0,0,0
1968,Philippines,0,49,53,0,0,0,0
1968,Portugal,0,20,24,0,0,0,0
1968,Puerto Rico,0,58,54,0,0,0,0
1968,San Marino,0,4,2,0,0,0,0
1968,Senegal,0,21,9,0,0,0,0
1968,Sierra Leone,0,3,4,0,0,0,0
1968,Singapore,0,4,6,0,0,0,0
1968,Spain,0,122,50,0,0,0,0
1968,Sri Lanka,0,3,3,0,0,0,0
1968,Sudan,0,5,7,0,0,0,0
1968,Suriname,0,1,1,0,0,0,0
1968,Syria,0,2,2,0,0,0,0
1968,Tanzania,0,4,5,0,0,0,0
1968,Thailand,0,41,18,0,0,0,0
1968,Trinidad,0,19,14,0,0,0,0
1968,Uruguay,0,27,31,0,0,0,0
1968,Vietnam,0,9,7,0,0,0,0
1968,"Virgin Islands, US",0,6,5,0,0,0,0
1968,Zambia,0,7,5,0,0,0,0
1972,Germany,1,721,189,33,34,39,106
1972,Russia,0,371,180,50,27,22,99
1972,USA,0,400,185,33,31,30,94
1972,Hungary,0,226,134,6,13,16,35
1972,Japan,0,184,113,13,8,8,29
1972,Bulgaria,0,130,92,6,10,5,21
1972,Poland,0,290,150,7,5,9,21
1972,Italy,0,224,123,5,3,10,18
1972,UK,0,284,159,4,5,9,18
1972,Australia,0,168,110,8,7,2,17
1972,Romania,0,159,102,3,6,7,16
1972,Sweden,0,131,90,4,6,6,16
1972,France,0,227,132,2,4,7,13
1972,Kenya,0,57,29,2,3,4,9
1972,Cuba,0,137,69,3,1,4,8
1972,Czech Republic,0,181,93,2,4,2,8
1972,Finland,0,96,75,3,1,4,8
1972,Canada,0,208,136,0,2,3,5
1972,Netherlands,0,119,72,3,1,1,5
1972,North Korea,0,37,23,1,1,3,5
1972,Serbia,0,126,73,2,1,2,5
1972,Norway,0,112,70,2,1,1,4
1972,Austria,0,111,68,0,1,2,3
1972,Colombia,0,59,39,0,1,2,3
1972,Iran,0,48,33,0,2,1,3
1972,New Zealand,0,89,63,1,1,1,3
1972,Switzerland,0,151,116,0,3,0,3
1972,Belgium,0,88,51,0,2,0,2
1972,Brazil,0,81,44,0,0,2,2
1972,Ethiopia,0,31,20,0,0,2,2
1972,Greece,0,60,46,0,2,0,2
1972,Uganda,0,33,19,1,1,0,2
1972,Argentina,0,92,62,0,1,0,1
1972,Denmark,0,126,73,1,0,0,1
1972,Ghana,0,35,17,0,0,1,1
1972,India,0,41,27,0,0,1,1
1972,Jamaica,0,33,27,0,0,1,1
1972,Lebanon,0,19,23,0,1,0,1
1972,Mexico,0,174,112,0,1,0,1
1972,Mongolia,0,39,39,0,1,0,1
1972,Niger,0,4,4,0,0,1,1
1972,Nigeria,0,25,24,0,0,1,1
1972,Pakistan,0,25,12,0,1,0,1
1972,South Korea,0,42,24,0,1,0,1
1972,Spain,0,123,59,0,0,1,1
1972,Tunisia,0,35,11,0,1,0,1
1972,Turkey,0,43,43,0,1,0,1
1972,Afghanistan,0,8,8,0,0,0,0
1972,Albania,0,5,3,0,0,0,0
1972,Algeria,0,5,5,0,0,0,0
1972,Bahamas,0,20,13,0,0,0,0
1972,Barbados,0,13,13,0,0,0,0
1972,Belize,0,1,2,0,0,0,0
1972,Benin,0,3,3,0,0,0,0
1972,Bermuda,0,9,4,0,0,0,0
1972,Boliva,0,11,9,0,0,0,0
1972,Burkina Faso,0,1,1,0,0,0,0
1972,Cambodia,0,9,14,0,0,0,0
1972,Cameroon,0,11,12,0,0,0,0
1972,Chad,0,4,4,0,0,0,0
1972,Chile,0,11,9,0,0,0,0
1972,China,0,10,13,0,0,0,0
1972,Costa Rica,0,3,4,0,0,0,0
1972,Curacao,0,2,2,0,0,0,0
1972,Dominican Republic,0,5,4,0,0,0,0
1972,Ecuador,0,2,4,0,0,0,0
1972,Egypt,0,23,16,0,0,0,0
1972,El Salvador,0,11,12,0,0,0,0
1972,Fiji,0,2,4,0,0,0,0
1972,Gabon,0,1,1,0,0,0,0
1972,Guatemala,0,8,10,0,0,0,0
1972,Guyana,0,3,4,0,0,0,0
1972,Haiti,0,7,7,0,0,0,0
1972,Iceland,0,25,16,0,0,0,0
1972,Indonesia,0,6,7,0,0,0,0
1972,Ireland,0,59,54,0,0,0,0
1972,Israel,0,14,14,0,0,0,0
1972,Ivory Coast,0,11,7,0,0,0,0
1972,Kuwait,0,4,4,0,0,0,0
1972,Lesotho,0,1,2,0,0,0,0
1972,Liberia,0,5,5,0,0,0,0
1972,Liechtenstein,0,6,11,0,0,0,0
1972,Luxembourg,0,11,8,0,0,0,0
1972,Madagascar,0,11,10,0,0,0,0
1972,Malawi,0,16,17,0,0,0,0
1972,Malaysia,0,45,20,0,0,0,0
1972,Mali,0,3,3,0,0,0,0
1972,Malta,0,5,2,0,0,0,0
1972,Monaco,0,5,4,0,0,0,0
1972,Morocco,0,35,19,0,0,0,0
1972,Myanmar,0,17,7,0,0,0,0
1972,Nepal,0,2,1,0,0,0,0
1972,Nicaragua,0,8,10,0,0,0,0
1972,Panama,0,7,8,0,0,0,0
1972,Paraguay,0,3,3,0,0,0,0
1972,Peru,0,20,25,0,0,0,0
1972,Philippines,0,53,47,0,0,0,0
1972,Portugal,0,29,28,0,0,0,0
1972,Puerto Rico,0,53,37,0,0,0,0
1972,Republic of Congo,0,6,5,0,0,0,0
1972,San Marino,0,7,4,0,0,0,0
1972,Saudi Arabia,0,10,11,0,0,0,0
1972,Senegal,0,38,23,0,0,0,0
1972,Singapore,0,7,12,0,0,0,0
1972,Somalia,0,3,4,0,0,0,0
1972,Sri Lanka,0,4,6,0,0,0,0
1972,Sudan,0,26,15,0,0,0,0
1972,Suriname,0,2,3,0,0,0,0
1972,Swaziland,0,2,4,0,0,0,0
1972,Syria,0,5,4,0,0,0,0
1972,Taiwan,0,21,41,0,0,0,0
1972,Tanzania,0,15,16,0,0,0,0
1972,Thailand,0,33,21,0,0,0,0
1972,Togo,0,7,5,0,0,0,0
1972,Trinidad,0,19,16,0,0,0,0
1972,Uruguay,0,13,12,0,0,0,0
1972,Venezuela,0,23,27,0,0,0,0
1972,Vietnam,0,2,1,0,0,0,0
1972,"Virgin Islands, US",0,16,9,0,0,0,0
1972,Zambia,0,11,12,0,0,0,0
1976,Germany,0,557,187,50,37,42,129
1976,Russia,0,410,189,49,41,35,125
1976,USA,0,396,189,34,35,25,94
1976,Romania,0,157,92,4,9,14,27
1976,Poland,0,207,116,7,6,13,26
1976,Japan,0,213,119,9,6,10,25
1976,Bulgaria,0,156,108,6,9,7,22
1976,Hungary,0,177,109,4,5,13,22
1976,Cuba,0,156,76,6,4,3,13
1976,Italy,0,210,122,2,7,4,13
1976,UK,0,242,148,3,5,5,13
1976,Canada,1,385,173,0,5,6,11
1976,France,0,206,128,2,3,4,9
1976,Czech Republic,0,163,79,2,2,4,8
1976,Serbia,0,88,52,2,3,3,8
1976,Belgium,0,101,80,0,3,3,6
1976,Finland,0,83,63,4,2,0,6
1976,South Korea,0,50,27,1,1,4,6
1976,Australia,0,180,115,0,1,4,5
1976,Netherlands,0,108,58,0,2,3,5
1976,Sweden,0,116,90,4,1,0,5
1976,New Zealand,0,80,52,2,1,1,4
1976,Switzerland,0,50,41,1,1,2,4
1976,Denmark,0,66,40,1,0,2,3
1976,Brazil,0,79,47,0,0,2,2
1976,Iran,0,84,50,0,1,1,2
1976,Jamaica,0,20,18,1,1,0,2
1976,Mexico,0,97,54,1,0,1,2
1976,North Korea,0,38,21,1,1,0,2
1976,Norway,0,66,44,1,1,0,2
1976,Portugal,0,19,27,0,2,0,2
1976,Spain,0,113,68,0,2,0,2
1976,Austria,0,60,44,0,0,1,1
1976,Bermuda,0,16,12,0,0,1,1
1976,Mongolia,0,32,29,0,1,0,1
1976,Pakistan,0,24,9,0,0,1,1
1976,Puerto Rico,0,80,74,0,0,1,1
1976,Thailand,0,42,33,0,0,1,1
1976,Trinidad,0,13,10,1,0,0,1
1976,Venezuela,0,32,35,0,1,0,1
1976,Andorra,0,3,2,0,0,0,0
1976,Antigua,0,10,11,0,0,0,0
1976,Argentina,0,69,50,0,0,0,0
1976,Bahamas,0,11,13,0,0,0,0
1976,Barbados,0,11,11,0,0,0,0
1976,Belize,0,4,4,0,0,0,0
1976,Boliva,0,4,5,0,0,0,0
1976,Cameroon,0,4,1,0,0,0,0
1976,Cayman Islands,0,2,1,0,0,0,0
1976,Chile,0,7,8,0,0,0,0
1976,China,0,25,27,0,0,0,0
1976,Colombia,0,35,30,0,0,0,0
1976,Costa Rica,0,5,9,0,0,0,0
1976,Curacao,0,4,4,0,0,0,0
1976,Dominican Republic,0,10,10,0,0,0,0
1976,Ecuador,0,5,8,0,0,0,0
1976,Egypt,0,26,7,0,0,0,0
1976,Fiji,0,2,5,0,0,0,0
1976,Greece,0,36,34,0,0,0,0
1976,Guatemala,0,28,8,0,0,0,0
1976,Haiti,0,13,14,0,0,0,0
1976,Honduras,0,3,2,0,0,0,0
1976,Iceland,0,13,22,0,0,0,0
1976,India,0,26,10,0,0,0,0
1976,Indonesia,0,7,11,0,0,0,0
1976,Ireland,0,44,34,0,0,0,0
1976,Israel,0,26,19,0,0,0,0
1976,Ivory Coast,0,8,8,0,0,0,0
1976,Kuwait,0,15,13,0,0,0,0
1976,Lebanon,0,3,4,0,0,0,0
1976,Liechtenstein,0,6,9,0,0,0,0
1976,Luxembourg,0,8,7,0,0,0,0
1976,Malaysia,0,23,9,0,0,0,0
1976,Monaco,0,8,6,0,0,0,0
1976,Morocco,0,9,9,0,0,0,0
1976,Nepal,0,1,1,0,0,0,0
1976,Nicaragua,0,15,19,0,0,0,0
1976,Panama,0,8,13,0,0,0,0
1976,Papua New Guinea,0,6,8,0,0,0,0
1976,Paraguay,0,4,6,0,0,0,0
1976,Peru,0,13,3,0,0,0,0
1976,Philippines,0,14,21,0,0,0,0
1976,San Marino,0,10,7,0,0,0,0
1976,Saudi Arabia,0,14,13,0,0,0,0
1976,Senegal,0,21,27,0,0,0,0
1976,Singapore,0,4,4,0,0,0,0
1976,Suriname,0,3,4,0,0,0,0
1976,Tunisia,0,15,5,0,0,0,0
1976,Turkey,0,27,27,0,0,0,0
1976,Uruguay,0,9,9,0,0,0,0
1976,"Virgin Islands, US",0,21,21,0,0,0,0
1980,Russia,1,489,202,80,69,46,195
1980,Germany,0,346,167,47,37,42,126
1980,Bulgaria,0,270,151,8,16,17,41
1980,Hungary,0,260,151,7,10,15,32
1980,Poland,0,306,162,3,14,15,32
1980,Romania,0,226,135,6,6,13,25
1980,UK,0,219,145,5,7,9,21
1980,Cuba,0,208,92,8,7,5,20
1980,Italy,0,159,88,8,3,4,15
1980,Czech Republic,0,209,114,2,3,9,14
1980,France,0,121,85,6,5,3,14
1980,Sweden,0,145,102,3,3,6,12
1980,Australia,0,120,92,2,2,5,9
1980,Serbia,0,164,69,2,3,4,9
1980,Finland,0,105,71,3,1,4,8
1980,Spain,0,155,75,1,3,2,6
1980,Denmark,0,58,30,2,1,2,5
1980,North Korea,0,47,40,0,3,2,5
1980,Austria,0,83,51,1,2,1,4
1980,Brazil,0,106,72,2,0,2,4
1980,Ethiopia,0,41,26,2,0,2,4
1980,Mexico,0,45,43,0,1,3,4
1980,Mongolia,0,43,41,0,2,2,4
1980,Greece,0,41,31,1,0,2,3
1980,Jamaica,0,18,15,0,0,3,3
1980,Netherlands,0,75,56,0,1,2,3
1980,Ireland,0,47,38,0,1,1,2
1980,Switzerland,0,73,45,2,0,0,2
1980,Tanzania,0,41,22,0,2,0,2
1980,Belgium,0,59,51,1,0,0,1
1980,Guyana,0,8,10,0,0,1,1
1980,India,0,71,30,1,0,0,1
1980,Lebanon,0,15,16,0,0,1,1
1980,Uganda,0,13,12,0,1,0,1
1980,Venezuela,0,37,20,0,1,0,1
1980,Zimbabwe,0,42,30,1,0,0,1
1980,Afghanistan,0,11,11,0,0,0,0
1980,Algeria,0,54,28,0,0,0,0
1980,Andorra,0,2,1,0,0,0,0
1980,Angola,0,11,14,0,0,0,0
1980,Benin,0,16,17,0,0,0,0
1980,Botswana,0,7,8,0,0,0,0
1980,Cameroon,0,25,23,0,0,0,0
1980,Colombia,0,23,7,0,0,0,0
1980,Costa Rica,0,29,18,0,0,0,0
1980,Cyprus,0,14,13,0,0,0,0
1980,Dominican Republic,0,6,7,0,0,0,0
1980,Ecuador,0,12,13,0,0,0,0
1980,Guatemala,0,10,7,0,0,0,0
1980,Guinea,0,9,10,0,0,0,0
1980,Iceland,0,9,11,0,0,0,0
1980,Iraq,0,43,26,0,0,0,0
1980,Jordan,0,4,3,0,0,0,0
1980,Kuwait,0,56,26,0,0,0,0
1980,Laos,0,19,16,0,0,0,0
1980,Lesotho,0,5,6,0,0,0,0
1980,Libya,0,29,20,0,0,0,0
1980,Luxembourg,0,3,4,0,0,0,0
1980,Madagascar,0,11,18,0,0,0,0
1980,Mali,0,7,7,0,0,0,0
1980,Malta,0,8,5,0,0,0,0
1980,Mozambique,0,14,16,0,0,0,0
1980,Myanmar,0,2,2,0,0,0,0
1980,Nepal,0,10,9,0,0,0,0
1980,New Zealand,0,4,5,0,0,0,0
1980,Nicaragua,0,5,6,0,0,0,0
1980,Nigeria,0,44,22,0,0,0,0
1980,Peru,0,28,26,0,0,0,0
1980,Portugal,0,11,17,0,0,0,0
1980,Puerto Rico,0,3,3,0,0,0,0
1980,Republic of Congo,0,23,8,0,0,0,0
1980,San Marino,0,16,10,0,0,0,0
1980,Senegal,0,32,22,0,0,0,0
1980,Seychelles,0,11,15,0,0,0,0
1980,Sierra Leone,0,14,16,0,0,0,0
1980,Sri Lanka,0,4,1,0,0,0,0
1980,Syria,0,67,55,0,0,0,0
1980,Trinidad,0,9,5,0,0,0,0
1980,Vietnam,0,30,31,0,0,0,0
1980,Zambia,0,37,25,0,0,0,0
1984,USA,1,522,217,82,61,30,173
1984,Germany,0,389,194,17,19,23,59
1984,Romania,0,124,86,19,16,17,52
1984,Canada,0,408,193,10,18,16,44
1984,UK,0,337,190,5,11,21,37
1984,China,0,262,119,15,8,9,32
1984,Italy,0,268,151,14,6,12,32
1984,Japan,0,226,147,10,7,14,31
1984,France,0,238,139,5,7,16,28
1984,Australia,0,242,137,4,8,12,24
1984,South Korea,0,174,96,6,6,7,19
1984,Sweden,0,174,138,2,11,6,19
1984,Serbia,0,139,53,7,4,7,18
1984,Netherlands,0,136,74,5,2,6,13
1984,Finland,0,86,76,4,2,6,12
1984,New Zealand,0,130,76,8,1,2,11
1984,Brazil,0,147,82,1,5,2,8
1984,Switzerland,0,129,91,0,4,4,8
1984,Denmark,0,60,33,0,3,3,6
1984,Mexico,0,99,87,2,3,1,6
1984,Spain,0,179,104,1,2,2,5
1984,Belgium,0,63,48,1,1,2,4
1984,Austria,0,102,72,1,1,1,3
1984,Jamaica,0,45,35,0,1,2,3
1984,Kenya,0,61,33,1,0,2,3
1984,Norway,0,103,76,0,1,2,3
1984,Portugal,0,38,32,1,0,2,3
1984,Turkey,0,46,49,0,0,3,3
1984,Venezuela,0,26,29,0,0,3,3
1984,Algeria,0,33,17,0,0,2,2
1984,Greece,0,63,49,0,1,1,2
1984,Morocco,0,34,18,2,0,0,2
1984,Nigeria,0,32,24,0,1,1,2
1984,Puerto Rico,0,51,45,0,1,1,2
1984,Cameroon,0,46,32,0,0,1,1
1984,Colombia,0,39,34,0,1,0,1
1984,Dominican Republic,0,19,20,0,0,1,1
1984,Egypt,0,113,74,0,1,0,1
1984,Iceland,0,30,17,0,0,1,1
1984,Ireland,0,42,35,0,1,0,1
1984,Ivory Coast,0,15,14,0,1,0,1
1984,Pakistan,0,31,15,1,0,0,1
1984,Peru,0,35,29,0,1,0,1
1984,Syria,0,9,9,0,1,0,1
1984,Taiwan,0,38,40,0,0,1,1
1984,Thailand,0,35,25,0,1,0,1
1984,Zambia,0,16,18,0,0,1,1
1984,Andorra,0,2,1,0,0,0,0
1984,Antigua,0,14,17,0,0,0,0
1984,Argentina,0,81,70,0,0,0,0
1984,Bahamas,0,22,23,0,0,0,0
1984,Bahrain,0,10,8,0,0,0,0
1984,Bangladesh,0,1,2,0,0,0,0
1984,Barbados,0,16,16,0,0,0,0
1984,Belize,0,11,7,0,0,0,0
1984,Benin,0,3,3,0,0,0,0
1984,Bermuda,0,12,10,0,0,0,0
1984,Bhutan,0,6,2,0,0,0,0
1984,Boliva,0,11,11,0,0,0,0
1984,Botswana,0,7,6,0,0,0,0
1984,Cayman Islands,0,8,7,0,0,0,0
1984,Central African Republic,0,3,3,0,0,0,0
1984,Chad,0,3,3,0,0,0,0
1984,Chile,0,52,25,0,0,0,0
1984,Costa Rica,0,28,16,0,0,0,0
1984,Curacao,0,8,10,0,0,0,0
1984,Cyprus,0,10,9,0,0,0,0
1984,Democratic Republic of the Congo,0,8,9,0,0,0,0
1984,Djibouti,0,3,1,0,0,0,0
1984,Ecuador,0,11,14,0,0,0,0
1984,El Salvador,0,10,15,0,0,0,0
1984,Equatorial Guinea,0,4,5,0,0,0,0
1984,Fiji,0,14,22,0,0,0,0
1984,Gabon,0,4,4,0,0,0,0
1984,Gambia,0,10,9,0,0,0,0
1984,Ghana,0,21,17,0,0,0,0
1984,Grenada,0,6,6,0,0,0,0
1984,Guatemala,0,24,40,0,0,0,0
1984,Guinea,0,1,1,0,0,0,0
1984,Guyana,0,10,12,0,0,0,0
1984,Haiti,0,3,2,0,0,0,0
1984,Honduras,0,10,20,0,0,0,0
1984,India,0,47,30,0,0,0,0
1984,Indonesia,0,16,16,0,0,0,0
1984,Iraq,0,23,11,0,0,0,0
1984,Israel,0,32,46,0,0,0,0
1984,Jordan,0,13,12,0,0,0,0
1984,Kuwait,0,23,17,0,0,0,0
1984,Lebanon,0,22,20,0,0,0,0
1984,Lesotho,0,4,4,0,0,0,0
1984,Liberia,0,7,7,0,0,0,0
1984,Liechtenstein,0,7,7,0,0,0,0
1984,Luxembourg,0,5,4,0,0,0,0
1984,Madagascar,0,5,5,0,0,0,0
1984,Malawi,0,15,16,0,0,0,0
1984,Malaysia,0,21,12,0,0,0,0
1984,Mali,0,4,5,0,0,0,0
1984,Malta,0,7,6,0,0,0,0
1984,Mauritania,0,2,2,0,0,0,0
1984,Mauritius,0,4,7,0,0,0,0
1984,Monaco,0,8,7,0,0,0,0
1984,Mozambique,0,9,11,0,0,0,0
1984,Myanmar,0,1,1,0,0,0,0
1984,Nepal,0,10,8,0,0,0,0
1984,Nicaragua,0,5,5,0,0,0,0
1984,Niger,0,4,4,0,0,0,0
1984,Oman,0,16,14,0,0,0,0
1984,Panama,0,8,10,0,0,0,0
1984,Papua New Guinea,0,7,12,0,0,0,0
1984,Paraguay,0,14,15,0,0,0,0
1984,Philippines,0,19,28,0,0,0,0
1984,Qatar,0,24,8,0,0,0,0
1984,Republic of Congo,0,9,10,0,0,0,0
1984,Rwanda,0,3,6,0,0,0,0
1984,Samoa,0,8,9,0,0,0,0
1984,San Marino,0,19,26,0,0,0,0
1984,Saudi Arabia,0,37,11,0,0,0,0
1984,Senegal,0,24,21,0,0,0,0
1984,Seychelles,0,9,15,0,0,0,0
1984,Sierra Leone,0,7,6,0,0,0,0
1984,Singapore,0,5,7,0,0,0,0
1984,Solomon Islands,0,3,3,0,0,0,0
1984,Somalia,0,7,6,0,0,0,0
1984,Sri Lanka,0,4,5,0,0,0,0
1984,Sudan,0,7,9,0,0,0,0
1984,Suriname,0,5,7,0,0,0,0
1984,Swaziland,0,8,11,0,0,0,0
1984,Tanzania,0,18,14,0,0,0,0
1984,Togo,0,6,6,0,0,0,0
1984,Tonga,0,7,7,0,0,0,0
1984,Trinidad,0,16,14,0,0,0,0
1984,Tunisia,0,23,17,0,0,0,0
1984,Uganda,0,26,24,0,0,0,0
1984,United Arab Emirates,0,7,8,0,0,0,0
1984,Uruguay,0,18,11,0,0,0,0
1984,"Virgin Islands, British",0,9,7,0,0,0,0
1984,"Virgin Islands, US",0,29,31,0,0,0,0
1984,Yemen,0,2,3,0,0,0,0
1984,Zimbabwe,0,15,18,0,0,0,0
1988,Germany,0,605,223,48,49,45,142
1988,Russia,0,480,221,54,31,46,131
1988,USA,0,527,230,36,31,27,94
1988,Bulgaria,0,172,120,10,12,13,35
1988,South Korea,1,399,218,12,10,11,33
1988,China,0,319,158,5,11,12,28
1988,Romania,0,68,59,7,11,6,24
1988,UK,0,345,191,5,10,9,24
1988,Hungary,0,188,135,11,6,6,23
1988,France,0,266,167,6,4,6,16
1988,Poland,0,143,105,2,5,9,16
1988,Australia,0,252,145,3,6,5,14
1988,Italy,0,253,140,6,4,4,14
1988,Japan,0,255,166,4,3,7,14
1988,New Zealand,0,83,58,3,2,8,13
1988,Serbia,0,155,72,3,4,5,12
1988,Sweden,0,185,113,0,4,7,11
1988,Canada,0,328,193,3,2,5,10
1988,Kenya,0,74,50,5,2,2,9
1988,Netherlands,0,147,86,2,2,5,9
1988,Czech Republic,0,163,97,3,3,2,8
1988,Brazil,0,160,106,1,2,3,6
1988,Norway,0,69,42,2,3,0,5
1988,Denmark,0,78,73,2,1,1,4
1988,Finland,0,78,66,1,1,2,4
1988,Spain,0,229,130,1,1,2,4
1988,Switzerland,0,99,83,0,2,2,4
1988,Morocco,0,27,25,1,0,2,3
1988,Argentina,0,118,53,0,1,1,2
1988,Belgium,0,59,65,0,0,2,2
1988,Jamaica,0,35,22,0,2,0,2
1988,Mexico,0,83,82,0,0,2,2
1988,Turkey,0,41,40,1,1,0,2
1988,Austria,0,73,62,1,0,0,1
1988,Chile,0,17,14,0,1,0,1
1988,Colombia,0,40,34,0,0,1,1
1988,Costa Rica,0,16,18,0,1,0,1
1988,Curacao,0,3,4,0,1,0,1
1988,Djibouti,0,6,5,0,0,1,1
1988,Greece,0,56,43,0,0,1,1
1988,Indonesia,0,29,32,0,1,0,1
1988,Iran,0,23,21,0,1,0,1
1988,Mongolia,0,28,28,0,0,1,1
1988,Pakistan,0,30,15,0,0,1,1
1988,Peru,0,21,15,0,1,0,1
1988,Philippines,0,31,40,0,0,1,1
1988,Portugal,0,65,59,1,0,0,1
1988,Senegal,0,23,23,0,1,0,1
1988,Suriname,0,6,10,1,0,0,1
1988,Thailand,0,14,12,0,0,1,1
1988,"Virgin Islands, US",0,22,27,0,1,0,1
1988,Afghanistan,0,5,5,0,0,0,0
1988,Algeria,0,42,29,0,0,0,0
1988,American Samoa,0,6,6,0,0,0,0
1988,Andorra,0,3,3,0,0,0,0
1988,Angola,0,24,27,0,0,0,0
1988,Antigua,0,15,19,0,0,0,0
1988,Aruba,0,8,10,0,0,0,0
1988,Bahamas,0,16,15,0,0,0,0
1988,Bahrain,0,7,7,0,0,0,0
1988,Bangladesh,0,6,8,0,0,0,0
1988,Barbados,0,17,20,0,0,0,0
1988,Belize,0,10,7,0,0,0,0
1988,Benin,0,7,7,0,0,0,0
1988,Bermuda,0,12,12,0,0,0,0
1988,Bhutan,0,3,2,0,0,0,0
1988,Boliva,0,7,12,0,0,0,0
1988,Botswana,0,8,8,0,0,0,0
1988,Burkina Faso,0,6,7,0,0,0,0
1988,Cameroon,0,15,21,0,0,0,0
1988,Cayman Islands,0,8,7,0,0,0,0
1988,Central African Republic,0,15,4,0,0,0,0
1988,Chad,0,6,6,0,0,0,0
1988,Cook Islands,0,7,8,0,0,0,0
1988,Cyprus,0,9,10,0,0,0,0
1988,Democratic Republic of the Congo,0,15,15,0,0,0,0
1988,Dominican Republic,0,16,15,0,0,0,0
1988,Ecuador,0,13,15,0,0,0,0
1988,Egypt,0,49,36,0,0,0,0
1988,El Salvador,0,6,7,0,0,0,0
1988,Equatorial Guinea,0,6,7,0,0,0,0
1988,Fiji,0,23,31,0,0,0,0
1988,Gabon,0,2,2,0,0,0,0
1988,Gambia,0,6,6,0,0,0,0
1988,Ghana,0,16,13,0,0,0,0
1988,Grenada,0,6,7,0,0,0,0
1988,Guam,0,19,22,0,0,0,0
1988,Guatemala,0,28,16,0,0,0,0
1988,Guinea,0,6,7,0,0,0,0
1988,Guyana,0,8,8,0,0,0,0
1988,Haiti,0,4,5,0,0,0,0
1988,Honduras,0,8,15,0,0,0,0
1988,Iceland,0,32,25,0,0,0,0
1988,India,0,46,27,0,0,0,0
1988,Iraq,0,27,13,0,0,0,0
1988,Ireland,0,61,47,0,0,0,0
1988,Israel,0,18,20,0,0,0,0
1988,Ivory Coast,0,28,10,0,0,0,0
1988,Jordan,0,7,9,0,0,0,0
1988,Kuwait,0,25,24,0,0,0,0
1988,Laos,0,3,3,0,0,0,0
1988,Lebanon,0,21,28,0,0,0,0
1988,Lesotho,0,6,5,0,0,0,0
1988,Liberia,0,8,10,0,0,0,0
1988,Libya,0,6,5,0,0,0,0
1988,Liechtenstein,0,12,15,0,0,0,0
1988,Luxembourg,0,8,11,0,0,0,0
1988,Malawi,0,16,16,0,0,0,0
1988,Malaysia,0,9,15,0,0,0,0
1988,Maldives,0,7,5,0,0,0,0
1988,Mali,0,6,8,0,0,0,0
1988,Malta,0,6,6,0,0,0,0
1988,Mauritania,0,6,7,0,0,0,0
1988,Mauritius,0,8,9,0,0,0,0
1988,Monaco,0,9,9,0,0,0,0
1988,Mozambique,0,8,12,0,0,0,0
1988,Myanmar,0,2,3,0,0,0,0
1988,Nepal,0,16,17,0,0,0,0
1988,Niger,0,6,4,0,0,0,0
1988,Nigeria,0,69,44,0,0,0,0
1988,Oman,0,8,9,0,0,0,0
1988,Panama,0,6,9,0,0,0,0
1988,Papua New Guinea,0,11,15,0,0,0,0
1988,Paraguay,0,10,11,0,0,0,0
1988,Puerto Rico,0,47,44,0,0,0,0
1988,Qatar,0,10,10,0,0,0,0
1988,Republic of Congo,0,7,7,0,0,0,0
1988,Rwanda,0,6,7,0,0,0,0
1988,Saint Vincent,0,6,6,0,0,0,0
1988,Samoa,0,11,11,0,0,0,0
1988,San Marino,0,11,12,0,0,0,0
1988,Saudi Arabia,0,9,12,0,0,0,0
1988,Sierra Leone,0,12,14,0,0,0,0
1988,Singapore,0,8,16,0,0,0,0
1988,Solomon Islands,0,4,5,0,0,0,0
1988,Somalia,0,5,4,0,0,0,0
1988,Sri Lanka,0,6,9,0,0,0,0
1988,Sudan,0,8,8,0,0,0,0
1988,Swaziland,0,11,11,0,0,0,0
1988,Syria,0,13,13,0,0,0,0
1988,Taiwan,0,61,84,0,0,0,0
1988,Tanzania,0,10,9,0,0,0,0
1988,Togo,0,6,6,0,0,0,0
1988,Tonga,0,5,7,0,0,0,0
1988,Trinidad,0,6,9,0,0,0,0
1988,Tunisia,0,41,14,0,0,0,0
1988,Uganda,0,24,22,0,0,0,0
1988,United Arab Emirates,0,12,15,0,0,0,0
1988,Uruguay,0,15,14,0,0,0,0
1988,Vanuatu,0,4,6,0,0,0,0
1988,Venezuela,0,17,15,0,0,0,0
1988,Vietnam,0,9,12,0,0,0,0
1988,"Virgin Islands, British",0,3,4,0,0,0,0
1988,Yemen,0,13,12,0,0,0,0
1988,Zambia,0,29,11,0,0,0,0
1988,Zimbabwe,0,29,38,0,0,0,0
1992,Russia,0,475,234,45,38,29,112
1992,USA,0,545,248,37,34,37,108
1992,Germany,0,463,237,33,21,28,82
1992,China,0,281,158,16,22,15,53
1992,Cuba,0,176,90,14,6,11,31
1992,Hungary,0,215,156,11,12,7,30
1992,France,0,339,196,8,5,16,29
1992,South Korea,0,225,134,12,5,11,28
1992,Australia,0,279,153,7,9,11,27
1992,Japan,0,256,166,3,8,11,22
1992,Spain,1,422,195,13,7,2,22
1992,UK,0,371,203,5,3,12,20
1992,Italy,0,304,169,6,5,8,19
1992,Poland,0,201,136,3,6,10,19
1992,Canada,0,295,199,7,4,7,18
1992,Romania,0,173,128,4,6,8,18
1992,Bulgaria,0,138,116,3,7,6,16
1992,Netherlands,0,201,105,2,6,7,15
1992,Sweden,0,187,121,1,7,4,12
1992,New Zealand,0,134,87,1,4,5,10
1992,North Korea,0,64,53,4,0,5,9
1992,Kenya,0,49,29,2,4,2,8
1992,Czech Republic,0,208,121,4,2,1,7
1992,Norway,0,83,64,2,4,1,7
1992,Denmark,0,110,67,1,1,4,6
1992,Turkey,0,41,43,2,2,2,6
1992,Finland,0,88,85,1,2,2,5
1992,Indonesia,0,42,31,2,2,1,5
1992,Jamaica,0,36,23,0,3,1,4
1992,Nigeria,0,55,34,0,3,1,4
1992,Belgium,0,68,70,0,1,2,3
1992,Brazil,0,182,107,2,1,0,3
1992,Croatia,0,39,23,0,1,2,3
1992,Ethiopia,0,20,11,1,0,2,3
1992,Individual Olympic Athletes,0,58,54,0,1,2,3
1992,Iran,0,36,36,0,1,2,3
1992,Latvia,0,34,31,0,2,1,3
1992,Morocco,0,44,24,1,1,1,3
1992,Algeria,0,35,27,1,0,1,2
1992,Austria,0,102,68,0,2,0,2
1992,Estonia,0,37,35,1,0,1,2
1992,Greece,0,70,53,2,0,0,2
1992,Ireland,0,58,47,1,1,0,2
1992,Israel,0,30,42,0,1,1,2
1992,Lithuania,0,47,31,1,0,1,2
1992,Mongolia,0,33,31,0,0,2,2
1992,Namibia,0,6,9,0,2,0,2
1992,Slovenia,0,35,34,0,0,2,2
1992,South Africa,0,93,87,0,2,0,2
1992,Argentina,0,84,68,0,0,1,1
1992,Bahamas,0,14,13,0,0,1,1
1992,Colombia,0,49,31,0,0,1,1
1992,Ghana,0,34,13,0,0,1,1
1992,Malaysia,0,26,11,0,0,1,1
1992,Mexico,0,102,71,0,1,0,1
1992,Pakistan,0,27,12,0,0,1,1
1992,Peru,0,16,18,0,1,0,1
1992,Philippines,0,26,29,0,0,1,1
1992,Puerto Rico,0,71,57,0,0,1,1
1992,Qatar,0,28,11,0,0,1,1
1992,Suriname,0,6,7,0,0,1,1
1992,Switzerland,0,102,80,1,0,0,1
1992,Taiwan,0,31,15,0,1,0,1
1992,Thailand,0,46,47,0,0,1,1
1992,Albania,0,7,8,0,0,0,0
1992,American Samoa,0,3,3,0,0,0,0
1992,Andorra,0,8,5,0,0,0,0
1992,Angola,0,28,21,0,0,0,0
1992,Antigua,0,13,15,0,0,0,0
1992,Aruba,0,5,4,0,0,0,0
1992,Bahrain,0,10,10,0,0,0,0
1992,Bangladesh,0,6,6,0,0,0,0
1992,Barbados,0,17,17,0,0,0,0
1992,Belize,0,10,10,0,0,0,0
1992,Benin,0,6,6,0,0,0,0
1992,Bermuda,0,20,20,0,0,0,0
1992,Bhutan,0,6,4,0,0,0,0
1992,Boliva,0,13,18,0,0,0,0
1992,Bosnia and Herzegovina,0,10,13,0,0,0,0
1992,Botswana,0,6,6,0,0,0,0
1992,Burkina Faso,0,4,4,0,0,0,0
1992,Cameroon,0,8,9,0,0,0,0
1992,Cayman Islands,0,10,7,0,0,0,0
1992,Central African Republic,0,15,16,0,0,0,0
1992,Chad,0,6,7,0,0,0,0
1992,Chile,0,12,12,0,0,0,0
1992,Cook Islands,0,2,2,0,0,0,0
1992,Costa Rica,0,16,18,0,0,0,0
1992,Curacao,0,4,4,0,0,0,0
1992,Cyprus,0,17,17,0,0,0,0
1992,Democratic Republic of the Congo,0,17,14,0,0,0,0
1992,Djibouti,0,8,7,0,0,0,0
1992,Dominican Republic,0,32,13,0,0,0,0
1992,Ecuador,0,13,15,0,0,0,0
1992,Egypt,0,75,32,0,0,0,0
1992,El Salvador,0,4,6,0,0,0,0
1992,Equatorial Guinea,0,7,8,0,0,0,0
1992,Fiji,0,18,32,0,0,0,0
1992,Gabon,0,5,5,0,0,0,0
1992,Gambia,0,5,5,0,0,0,0
1992,Grenada,0,4,5,0,0,0,0
1992,Guam,0,22,27,0,0,0,0
1992,Guatemala,0,14,27,0,0,0,0
1992,Guinea,0,8,11,0,0,0,0
1992,Guyana,0,6,7,0,0,0,0
1992,Haiti,0,7,8,0,0,0,0
1992,Honduras,0,10,25,0,0,0,0
1992,Iceland,0,27,15,0,0,0,0
1992,India,0,52,36,0,0,0,0
1992,Iraq,0,8,8,0,0,0,0
1992,Ivory Coast,0,13,11,0,0,0,0
1992,Jordan,0,4,5,0,0,0,0
1992,Kuwait,0,32,18,0,0,0,0
1992,Laos,0,6,7,0,0,0,0
1992,Lebanon,0,12,15,0,0,0,0
1992,Lesotho,0,6,8,0,0,0,0
1992,Libya,0,5,5,0,0,0,0
1992,Liechtenstein,0,7,8,0,0,0,0
1992,Luxembourg,0,6,8,0,0,0,0
1992,Madagascar,0,13,15,0,0,0,0
1992,Malawi,0,4,4,0,0,0,0
1992,Maldives,0,7,8,0,0,0,0
1992,Mali,0,5,6,0,0,0,0
1992,Malta,0,6,8,0,0,0,0
1992,Mauritania,0,6,6,0,0,0,0
1992,Mauritius,0,13,17,0,0,0,0
1992,Monaco,0,2,4,0,0,0,0
1992,Mozambique,0,6,7,0,0,0,0
1992,Myanmar,0,4,5,0,0,0,0
1992,Nepal,0,2,2,0,0,0,0
1992,Nicaragua,0,8,9,0,0,0,0
1992,Niger,0,3,3,0,0,0,0
1992,Oman,0,5,5,0,0,0,0
1992,Panama,0,5,7,0,0,0,0
1992,Papua New Guinea,0,13,16,0,0,0,0
1992,Paraguay,0,27,12,0,0,0,0
1992,Portugal,0,90,71,0,0,0,0
1992,Republic of Congo,0,7,7,0,0,0,0
1992,Rwanda,0,10,8,0,0,0,0
1992,Saint Vincent,0,6,5,0,0,0,0
1992,Samoa,0,5,5,0,0,0,0
1992,San Marino,0,17,15,0,0,0,0
1992,Saudi Arabia,0,9,13,0,0,0,0
1992,Senegal,0,20,20,0,0,0,0
1992,Seychelles,0,11,18,0,0,0,0
1992,Sierra Leone,0,11,12,0,0,0,0
1992,Singapore,0,14,26,0,0,0,0
1992,Solomon Islands,0,1,1,0,0,0,0
1992,Sri Lanka,0,11,16,0,0,0,0
1992,Sudan,0,6,7,0,0,0,0
1992,Swaziland,0,6,10,0,0,0,0
1992,Syria,0,8,9,0,0,0,0
1992,Tanzania,0,9,7,0,0,0,0
1992,Togo,0,6,5,0,0,0,0
1992,Tonga,0,5,5,0,0,0,0
1992,Trinidad,0,7,7,0,0,0,0
1992,Tunisia,0,13,13,0,0,0,0
1992,Uganda,0,8,9,0,0,0,0
1992,United Arab Emirates,0,13,19,0,0,0,0
1992,Uruguay,0,16,15,0,0,0,0
1992,Vanuatu,0,6,8,0,0,0,0
1992,Venezuela,0,26,16,0,0,0,0
1992,Vietnam,0,7,10,0,0,0,0
1992,"Virgin Islands, British",0,4,2,0,0,0,0
1992,"Virgin Islands, US",0,25,29,0,0,0,0
1992,Yemen,0,8,8,0,0,0,0
1992,Zambia,0,9,11,0,0,0,0
1992,Zimbabwe,0,19,22,0,0,0,0
1996,USA,1,648,263,44,32,25,101
1996,Germany,0,464,234,20,18,27,65
1996,Russia,0,390,212,26,21,16,63
1996,China,0,312,163,17,22,12,51
1996,Australia,0,417,211,9,9,23,41
1996,France,0,299,183,15,7,15,37
1996,Italy,0,340,172,13,10,12,35
1996,South Korea,0,299,160,7,15,5,27
1996,Cuba,0,164,84,9,8,8,25
1996,Ukraine,0,231,148,9,2,12,23
1996,Canada,0,303,189,3,11,8,22
1996,Hungary,0,212,145,7,4,10,21
1996,Netherlands,0,239,94,4,5,10,19
1996,Romania,0,165,122,4,7,8,19
1996,Poland,0,165,126,7,5,5,17
1996,Spain,0,289,157,5,6,6,17
1996,Belarus,0,157,115,1,6,8,15
1996,Brazil,0,221,93,3,3,9,15
1996,Bulgaria,0,110,89,3,7,5,15
1996,UK,0,300,175,1,8,6,15
1996,Japan,0,306,168,3,6,5,14
1996,Czech Republic,0,115,110,4,3,4,11
1996,Kazakhstan,0,96,99,3,4,4,11
1996,Greece,0,121,94,4,4,0,8
1996,Kenya,0,52,27,1,4,3,8
1996,Sweden,0,177,109,2,4,2,8
1996,Norway,0,97,65,2,2,3,7
1996,Switzerland,0,115,83,4,3,0,7
1996,Belgium,0,61,55,2,2,2,6
1996,Denmark,0,119,66,4,1,1,6
1996,Jamaica,0,46,29,1,3,2,6
1996,New Zealand,0,95,81,3,2,1,6
1996,Nigeria,0,65,38,2,1,3,6
1996,Turkey,0,53,55,4,1,1,6
1996,North Korea,0,24,25,2,1,2,5
1996,South Africa,0,84,62,3,1,1,5
1996,Finland,0,76,74,1,2,1,4
1996,Indonesia,0,40,23,1,1,2,4
1996,Ireland,0,78,70,3,0,1,4
1996,Serbia,0,68,35,1,1,2,4
1996,Algeria,0,45,29,2,0,1,3
1996,Argentina,0,179,102,0,2,1,3
1996,Austria,0,72,53,0,1,2,3
1996,Ethiopia,0,18,10,2,0,1,3
1996,Iran,0,18,18,1,1,1,3
1996,Slovakia,0,71,69,1,1,1,3
1996,Armenia,0,32,36,1,1,0,2
1996,Croatia,0,84,57,1,1,0,2
1996,Georgia,0,34,39,0,0,2,2
1996,Malaysia,0,35,21,0,1,1,2
1996,Moldova,0,40,41,0,1,1,2
1996,Morocco,0,34,28,0,0,2,2
1996,Namibia,0,8,10,0,2,0,2
1996,Portugal,0,107,79,1,0,1,2
1996,Slovenia,0,37,34,0,2,0,2
1996,Thailand,0,37,42,1,0,1,2
1996,Trinidad,0,12,14,0,0,2,2
1996,Uzbekistan,0,71,70,0,1,1,2
1996,Azerbaijan,0,23,23,0,1,0,1
1996,Bahamas,0,26,17,0,1,0,1
1996,Burundi,0,7,6,1,0,0,1
1996,Costa Rica,0,11,13,1,0,0,1
1996,Ecuador,0,19,18,1,0,0,1
1996,India,0,49,31,0,0,1,1
1996,Israel,0,25,26,0,0,1,1
1996,Latvia,0,47,47,0,1,0,1
1996,Lithuania,0,61,49,0,0,1,1
1996,Mexico,0,98,57,0,0,1,1
1996,Mongolia,0,16,16,0,0,1,1
1996,Mozambique,0,3,3,0,0,1,1
1996,Philippines,0,12,18,0,1,0,1
1996,Puerto Rico,0,69,60,0,0,1,1
1996,Syria,0,7,8,1,0,0,1
1996,Taiwan,0,74,63,0,1,0,1
1996,Tonga,0,5,5,0,1,0,1
1996,Tunisia,0,51,24,0,0,1,1
1996,Uganda,0,10,9,0,0,1,1
1996,Zambia,0,8,8,0,1,0,1
1996,Afghanistan,0,2,2,0,0,0,0
1996,Albania,0,7,7,0,0,0,0
1996,American Samoa,0,7,6,0,0,0,0
1996,Andorra,0,8,7,0,0,0,0
1996,Angola,0,28,8,0,0,0,0
1996,Antigua,0,13,9,0,0,0,0
1996,Aruba,0,3,3,0,0,0,0
1996,Bahrain,0,5,3,0,0,0,0
1996,Bangladesh,0,4,4,0,0,0,0
1996,Barbados,0,13,21,0,0,0,0
1996,Belize,0,5,5,0,0,0,0
1996,Benin,0,5,4,0,0,0,0
1996,Bermuda,0,9,9,0,0,0,0
1996,Bhutan,0,2,2,0,0,0,0
1996,Boliva,0,8,9,0,0,0,0
1996,Bosnia and Herzegovina,0,9,12,0,0,0,0
1996,Botswana,0,7,4,0,0,0,0
1996,Brunei,0,1,1,0,0,0,0
1996,Burkina Faso,0,5,5,0,0,0,0
1996,Cambodia,0,5,5,0,0,0,0
1996,Cameroon,0,15,13,0,0,0,0
1996,Cape Verde,0,3,3,0,0,0,0
1996,Cayman Islands,0,9,7,0,0,0,0
1996,Central African Republic,0,5,5,0,0,0,0
1996,Chad,0,4,4,0,0,0,0
1996,Chile,0,21,18,0,0,0,0
1996,Colombia,0,48,44,0,0,0,0
1996,Comoros,0,4,4,0,0,0,0
1996,Cook Islands,0,3,3,0,0,0,0
1996,Curacao,0,6,7,0,0,0,0
1996,Cyprus,0,17,16,0,0,0,0
1996,Democratic Republic of the Congo,0,14,2,0,0,0,0
1996,Djibouti,0,5,4,0,0,0,0
1996,Dominica,0,6,6,0,0,0,0
1996,Dominican Republic,0,16,16,0,0,0,0
1996,Egypt,0,29,17,0,0,0,0
1996,El Salvador,0,8,10,0,0,0,0
1996,Equatorial Guinea,0,5,5,0,0,0,0
1996,Estonia,0,43,36,0,0,0,0
1996,Fiji,0,17,14,0,0,0,0
1996,Gabon,0,7,6,0,0,0,0
1996,Gambia,0,9,6,0,0,0,0
1996,Ghana,0,35,15,0,0,0,0
1996,Grenada,0,5,2,0,0,0,0
1996,Guam,0,8,9,0,0,0,0
1996,Guatemala,0,26,20,0,0,0,0
1996,Guinea,0,5,5,0,0,0,0
1996,Guinea-Bissau,0,3,3,0,0,0,0
1996,Guyana,0,7,6,0,0,0,0
1996,Haiti,0,7,7,0,0,0,0
1996,Honduras,0,7,7,0,0,0,0
1996,Iceland,0,9,15,0,0,0,0
1996,Iraq,0,3,3,0,0,0,0
1996,Ivory Coast,0,11,8,0,0,0,0
1996,Jordan,0,5,5,0,0,0,0
1996,Kuwait,0,25,16,0,0,0,0
1996,Kyrgyzstan,0,33,39,0,0,0,0
1996,Laos,0,5,2,0,0,0,0
1996,Lebanon,0,1,1,0,0,0,0
1996,Lesotho,0,9,5,0,0,0,0
1996,Liberia,0,5,3,0,0,0,0
1996,Libya,0,5,5,0,0,0,0
1996,Liechtenstein,0,2,2,0,0,0,0
1996,Luxembourg,0,6,7,0,0,0,0
1996,Macedonia,0,11,16,0,0,0,0
1996,Madagascar,0,11,10,0,0,0,0
1996,Malawi,0,2,2,0,0,0,0
1996,Maldives,0,6,6,0,0,0,0
1996,Mali,0,3,4,0,0,0,0
1996,Malta,0,7,10,0,0,0,0
1996,Mauritania,0,4,4,0,0,0,0
1996,Mauritius,0,26,23,0,0,0,0
1996,Monaco,0,3,4,0,0,0,0
1996,Myanmar,0,3,3,0,0,0,0
1996,Nauru,0,3,3,0,0,0,0
1996,Nepal,0,6,6,0,0,0,0
1996,Nicaragua,0,26,9,0,0,0,0
1996,Niger,0,3,3,0,0,0,0
1996,Oman,0,4,5,0,0,0,0
1996,Pakistan,0,24,9,0,0,0,0
1996,Palestine,0,1,1,0,0,0,0
1996,Panama,0,7,9,0,0,0,0
1996,Papua New Guinea,0,11,11,0,0,0,0
1996,Paraguay,0,7,7,0,0,0,0
1996,Peru,0,29,22,0,0,0,0
1996,Qatar,0,12,10,0,0,0,0
1996,Republic of Congo,0,5,5,0,0,0,0
1996,Rwanda,0,4,4,0,0,0,0
1996,Saint Kitts,0,10,5,0,0,0,0
1996,Saint Lucia,0,6,5,0,0,0,0
1996,Saint Vincent,0,8,6,0,0,0,0
1996,Samoa,0,5,5,0,0,0,0
1996,San Marino,0,7,7,0,0,0,0
1996,Sao Tome and Principe,0,2,2,0,0,0,0
1996,Saudi Arabia,0,29,13,0,0,0,0
1996,Senegal,0,11,8,0,0,0,0
1996,Seychelles,0,9,9,0,0,0,0
1996,Sierra Leone,0,14,10,0,0,0,0
1996,Singapore,0,14,27,0,0,0,0
1996,Solomon Islands,0,4,4,0,0,0,0
1996,Somalia,0,4,4,0,0,0,0
1996,Sri Lanka,0,9,9,0,0,0,0
1996,Sudan,0,4,4,0,0,0,0
1996,Suriname,0,7,11,0,0,0,0
1996,Swaziland,0,6,5,0,0,0,0
1996,Tajikistan,0,8,8,0,0,0,0
1996,Tanzania,0,7,5,0,0,0,0
1996,Togo,0,5,4,0,0,0,0
1996,Turkmenistan,0,7,7,0,0,0,0
1996,United Arab Emirates,0,4,4,0,0,0,0
1996,Uruguay,0,14,14,0,0,0,0
1996,Vanuatu,0,4,4,0,0,0,0
1996,Venezuela,0,39,36,0,0,0,0
1996,Vietnam,0,6,6,0,0,0,0
1996,"Virgin Islands, British",0,7,5,0,0,0,0
1996,"Virgin Islands, US",0,12,11,0,0,0,0
1996,Yemen,0,4,4,0,0,0,0
1996,Zimbabwe,0,13,15,0,0,0,0
2000,USA,0,586,265,36,24,31,91
2000,Russia,0,435,238,32,28,29,89
2000,Australia,1,617,270,16,25,17,58
2000,China,0,297,171,28,16,14,58
2000,Germany,0,422,234,13,17,26,56
2000,France,0,336,196,13,14,11,38
2000,Italy,0,361,175,13,8,13,34
2000,Cuba,0,229,135,11,11,7,29
2000,South Korea,0,279,144,8,10,10,28
2000,UK,0,310,179,11,10,7,28
2000,Romania,0,145,116,11,6,9,26
2000,Netherlands,0,231,95,12,9,4,25
2000,Ukraine,0,230,185,3,10,10,23
2000,Japan,0,266,156,5,8,5,18
2000,Belarus,0,139,109,3,3,11,17
2000,Hungary,0,178,137,8,6,3,17
2000,Canada,0,294,175,3,3,8,14
2000,Poland,0,187,133,6,5,3,14
2000,Bulgaria,0,91,85,5,6,2,13
2000,Greece,0,140,114,4,6,3,13
2000,Brazil,0,198,96,0,6,6,12
2000,Sweden,0,150,92,4,5,3,12
2000,Spain,0,321,165,3,3,5,11
2000,Norway,0,93,54,4,3,3,10
2000,Jamaica,0,48,28,0,6,3,9
2000,Switzerland,0,102,82,1,6,2,9
2000,Czech Republic,0,119,96,2,3,3,8
2000,Ethiopia,0,26,11,4,1,3,8
2000,Kazakhstan,0,130,104,3,4,0,7
2000,Kenya,0,56,24,2,3,2,7
2000,Denmark,0,97,55,2,3,1,6
2000,Georgia,0,36,41,0,0,6,6
2000,Indonesia,0,47,32,1,3,2,6
2000,Mexico,0,78,67,1,2,3,6
2000,Algeria,0,47,42,1,1,3,5
2000,Belgium,0,68,64,0,2,3,5
2000,Lithuania,0,61,50,2,0,3,5
2000,Morocco,0,55,28,0,1,4,5
2000,Slovakia,0,108,63,1,3,1,5
2000,South Africa,0,127,68,0,2,3,5
2000,Taiwan,0,55,59,0,1,4,5
2000,Turkey,0,57,58,3,0,2,5
2000,Argentina,0,143,98,0,2,2,4
2000,Finland,0,70,64,2,1,1,4
2000,Iran,0,33,33,3,0,1,4
2000,New Zealand,0,147,95,1,0,3,4
2000,North Korea,0,31,34,0,1,3,4
2000,Uzbekistan,0,70,69,1,1,2,4
2000,Austria,0,92,68,2,1,0,3
2000,Azerbaijan,0,31,32,2,0,1,3
2000,Bahamas,0,25,18,2,0,1,3
2000,Estonia,0,33,29,1,0,2,3
2000,Latvia,0,45,47,1,1,1,3
2000,Nigeria,0,83,37,1,2,0,3
2000,Serbia,0,109,50,1,1,1,3
2000,Thailand,0,52,51,1,0,2,3
2000,Costa Rica,0,7,9,0,0,2,2
2000,Croatia,0,88,53,1,0,1,2
2000,Moldova,0,34,34,0,1,1,2
2000,Portugal,0,61,50,0,0,2,2
2000,Saudi Arabia,0,18,14,0,1,1,2
2000,Slovenia,0,74,53,2,0,0,2
2000,Trinidad,0,19,18,0,1,1,2
2000,Armenia,0,25,26,0,0,1,1
2000,Barbados,0,18,21,0,0,1,1
2000,Cameroon,0,34,14,1,0,0,1
2000,Chile,0,50,28,0,0,1,1
2000,Colombia,0,44,45,1,0,0,1
2000,Iceland,0,18,28,0,0,1,1
2000,India,0,65,38,0,0,1,1
2000,Ireland,0,64,52,0,1,0,1
2000,Israel,0,39,43,0,0,1,1
2000,Kuwait,0,29,10,0,0,1,1
2000,Kyrgyzstan,0,48,59,0,0,1,1
2000,Macedonia,0,10,15,0,0,1,1
2000,Mozambique,0,4,4,1,0,0,1
2000,Qatar,0,17,14,0,0,1,1
2000,Sri Lanka,0,18,16,0,1,0,1
2000,Uruguay,0,15,16,0,1,0,1
2000,Vietnam,0,7,7,0,1,0,1
2000,Albania,0,4,5,0,0,0,0
2000,American Samoa,0,4,4,0,0,0,0
2000,Andorra,0,5,5,0,0,0,0
2000,Angola,0,30,7,0,0,0,0
2000,Antigua,0,3,4,0,0,0,0
2000,Aruba,0,5,5,0,0,0,0
2000,Bahrain,0,4,4,0,0,0,0
2000,Bangladesh,0,5,6,0,0,0,0
2000,Belize,0,2,2,0,0,0,0
2000,Benin,0,4,4,0,0,0,0
2000,Bermuda,0,6,6,0,0,0,0
2000,Bhutan,0,2,2,0,0,0,0
2000,Boliva,0,5,5,0,0,0,0
2000,Bosnia and Herzegovina,0,9,10,0,0,0,0
2000,Botswana,0,7,5,0,0,0,0
2000,Brunei,0,2,2,0,0,0,0
2000,Burkina Faso,0,4,4,0,0,0,0
2000,Burundi,0,6,5,0,0,0,0
2000,Cambodia,0,4,4,0,0,0,0
2000,Cape Verde,0,2,2,0,0,0,0
2000,Cayman Islands,0,3,4,0,0,0,0
2000,Central African Republic,0,3,3,0,0,0,0
2000,Chad,0,2,3,0,0,0,0
2000,Comoros,0,2,2,0,0,0,0
2000,Cook Islands,0,2,2,0,0,0,0
2000,Curacao,0,7,8,0,0,0,0
2000,Cyprus,0,22,20,0,0,0,0
2000,Democratic Republic of the Congo,0,2,3,0,0,0,0
2000,Djibouti,0,2,2,0,0,0,0
2000,Dominica,0,4,4,0,0,0,0
2000,Dominican Republic,0,13,13,0,0,0,0
2000,Ecuador,0,10,11,0,0,0,0
2000,Egypt,0,89,64,0,0,0,0
2000,El Salvador,0,8,10,0,0,0,0
2000,Equatorial Guinea,0,4,4,0,0,0,0
2000,Eritrea,0,3,3,0,0,0,0
2000,Fiji,0,7,9,0,0,0,0
2000,Gabon,0,5,6,0,0,0,0
2000,Gambia,0,2,2,0,0,0,0
2000,Ghana,0,22,13,0,0,0,0
2000,Grenada,0,3,3,0,0,0,0
2000,Guam,0,7,7,0,0,0,0
2000,Guatemala,0,15,14,0,0,0,0
2000,Guinea,0,6,6,0,0,0,0
2000,Guinea-Bissau,0,3,3,0,0,0,0
2000,Guyana,0,4,4,0,0,0,0
2000,Haiti,0,5,5,0,0,0,0
2000,Honduras,0,20,4,0,0,0,0
2000,Individual Olympic Athletes,0,4,4,0,0,0,0
2000,Iraq,0,4,4,0,0,0,0
2000,Ivory Coast,0,14,12,0,0,0,0
2000,Jordan,0,8,8,0,0,0,0
2000,Laos,0,3,3,0,0,0,0
2000,Lebanon,0,6,6,0,0,0,0
2000,Lesotho,0,6,6,0,0,0,0
2000,Liberia,0,8,7,0,0,0,0
2000,Libya,0,3,3,0,0,0,0
2000,Liechtenstein,0,2,2,0,0,0,0
2000,Luxembourg,0,7,8,0,0,0,0
2000,Madagascar,0,11,10,0,0,0,0
2000,Malawi,0,2,2,0,0,0,0
2000,Malaysia,0,40,32,0,0,0,0
2000,Maldives,0,4,4,0,0,0,0
2000,Mali,0,5,5,0,0,0,0
2000,Malta,0,7,7,0,0,0,0
2000,Mauritania,0,2,2,0,0,0,0
2000,Mauritius,0,20,20,0,0,0,0
2000,Micronesia,0,5,5,0,0,0,0
2000,Monaco,0,4,4,0,0,0,0
2000,Mongolia,0,20,21,0,0,0,0
2000,Myanmar,0,7,7,0,0,0,0
2000,Namibia,0,11,16,0,0,0,0
2000,Nauru,0,2,2,0,0,0,0
2000,Nepal,0,5,5,0,0,0,0
2000,Nicaragua,0,6,6,0,0,0,0
2000,Niger,0,4,4,0,0,0,0
2000,Oman,0,6,5,0,0,0,0
2000,Pakistan,0,27,11,0,0,0,0
2000,Palau,0,5,5,0,0,0,0
2000,Palestine,0,2,2,0,0,0,0
2000,Panama,0,6,7,0,0,0,0
2000,Papua New Guinea,0,5,5,0,0,0,0
2000,Paraguay,0,5,5,0,0,0,0
2000,Peru,0,21,12,0,0,0,0
2000,Philippines,0,20,22,0,0,0,0
2000,Puerto Rico,0,29,31,0,0,0,0
2000,Republic of Congo,0,5,5,0,0,0,0
2000,Rwanda,0,5,5,0,0,0,0
2000,Saint Kitts,0,2,4,0,0,0,0
2000,Saint Lucia,0,5,5,0,0,0,0
2000,Saint Vincent,0,4,4,0,0,0,0
2000,Samoa,0,5,5,0,0,0,0
2000,San Marino,0,4,4,0,0,0,0
2000,Sao Tome and Principe,0,2,2,0,0,0,0
2000,Senegal,0,26,15,0,0,0,0
2000,Seychelles,0,9,9,0,0,0,0
2000,Sierra Leone,0,3,3,0,0,0,0
2000,Singapore,0,14,20,0,0,0,0
2000,Solomon Islands,0,2,2,0,0,0,0
2000,Somalia,0,2,2,0,0,0,0
2000,Sudan,0,3,3,0,0,0,0
2000,Suriname,0,4,5,0,0,0,0
2000,Swaziland,0,6,6,0,0,0,0
2000,Syria,0,8,7,0,0,0,0
2000,Tajikistan,0,4,4,0,0,0,0
2000,Tanzania,0,4,2,0,0,0,0
2000,Togo,0,3,3,0,0,0,0
2000,Tonga,0,3,3,0,0,0,0
2000,Tunisia,0,47,34,0,0,0,0
2000,Turkmenistan,0,8,8,0,0,0,0
2000,Uganda,0,13,13,0,0,0,0
2000,United Arab Emirates,0,4,5,0,0,0,0
2000,Vanuatu,0,3,3,0,0,0,0
2000,Venezuela,0,50,49,0,0,0,0
2000,"Virgin Islands, British",0,1,1,0,0,0,0
2000,"Virgin Islands, US",0,9,12,0,0,0,0
2000,Yemen,0,2,2,0,0,0,0
2000,Zambia,0,8,8,0,0,0,0
2000,Zimbabwe,0,16,19,0,0,0,0
2004,USA,0,533,254,36,39,26,101
2004,Russia,0,446,235,28,26,36,90
2004,China,0,404,207,32,18,14,64
2004,Australia,0,470,219,17,16,17,50
2004,Germany,0,441,228,13,16,20,49
2004,Japan,0,305,169,16,9,12,37
2004,France,0,308,193,11,9,13,33
2004,Italy,0,364,175,10,11,11,32
2004,South Korea,0,260,149,9,12,9,30
2004,UK,0,264,162,9,9,12,30
2004,Cuba,0,151,108,9,7,11,27
2004,Netherlands,0,210,99,4,9,9,22
2004,Ukraine,0,239,175,8,5,9,22
2004,Spain,0,316,155,3,11,6,20
2004,Romania,0,108,88,8,5,6,19
2004,Hungary,0,208,138,8,6,3,17
2004,Greece,1,426,215,6,6,4,16
2004,Belarus,0,151,121,2,5,6,13
2004,Bulgaria,0,95,94,2,1,9,12
2004,Canada,0,262,151,3,6,3,12
2004,Turkey,0,64,65,3,3,5,11
2004,Brazil,0,243,133,5,2,3,10
2004,Poland,0,194,124,3,2,5,10
2004,Czech Republic,0,142,104,1,3,5,9
2004,Denmark,0,92,59,2,1,5,8
2004,Kazakhstan,0,114,95,1,4,3,8
2004,Thailand,0,42,46,3,1,4,8
2004,Austria,0,74,56,2,4,1,7
2004,Ethiopia,0,26,12,2,3,2,7
2004,Kenya,0,46,16,1,4,2,7
2004,Sweden,0,115,79,4,2,1,7
2004,Argentina,0,152,86,2,0,4,6
2004,Iran,0,37,35,2,2,2,6
2004,Norway,0,52,35,5,0,1,6
2004,Slovakia,0,64,59,2,2,2,6
2004,South Africa,0,106,68,1,3,2,6
2004,Azerbaijan,0,36,36,1,0,4,5
2004,Croatia,0,81,57,1,2,2,5
2004,Egypt,0,96,48,1,1,3,5
2004,Jamaica,0,47,27,2,1,2,5
2004,New Zealand,0,148,84,3,2,0,5
2004,North Korea,0,36,34,0,4,1,5
2004,Switzerland,0,98,83,1,1,3,5
2004,Taiwan,0,88,52,2,2,1,5
2004,Uzbekistan,0,69,71,2,1,2,5
2004,Georgia,0,32,38,2,2,0,4
2004,Indonesia,0,38,27,1,1,2,4
2004,Latvia,0,32,37,0,4,0,4
2004,Mexico,0,109,68,0,3,1,4
2004,Slovenia,0,79,66,0,1,3,4
2004,Belgium,0,50,41,1,0,2,3
2004,Chile,0,22,25,2,0,1,3
2004,Estonia,0,42,34,0,1,2,3
2004,Lithuania,0,59,44,1,2,0,3
2004,Morocco,0,55,28,2,1,0,3
2004,Portugal,0,81,63,0,2,1,3
2004,Zimbabwe,0,12,11,1,1,1,3
2004,Bahamas,0,22,18,1,0,1,2
2004,Colombia,0,53,59,0,0,2,2
2004,Finland,0,53,53,0,2,0,2
2004,Israel,0,36,41,1,0,1,2
2004,Nigeria,0,70,31,0,0,2,2
2004,Serbia,0,85,39,0,2,0,2
2004,Venezuela,0,48,51,0,0,2,2
2004,Cameroon,0,17,15,1,0,0,1
2004,Dominican Republic,0,33,22,1,0,0,1
2004,Eritrea,0,4,3,0,0,1,1
2004,India,0,73,43,0,1,0,1
2004,Mongolia,0,20,21,0,0,1,1
2004,Paraguay,0,22,6,0,1,0,1
2004,Syria,0,6,6,0,0,1,1
2004,Trinidad,0,19,18,0,0,1,1
2004,United Arab Emirates,0,4,5,1,0,0,1
2004,Afghanistan,0,5,5,0,0,0,0
2004,Albania,0,7,7,0,0,0,0
2004,Algeria,0,61,57,0,0,0,0
2004,American Samoa,0,3,3,0,0,0,0
2004,Andorra,0,6,6,0,0,0,0
2004,Angola,0,30,5,0,0,0,0
2004,Antigua,0,5,5,0,0,0,0
2004,Armenia,0,18,19,0,0,0,0
2004,Aruba,0,4,4,0,0,0,0
2004,Bahrain,0,10,10,0,0,0,0
2004,Bangladesh,0,4,4,0,0,0,0
2004,Barbados,0,10,15,0,0,0,0
2004,Belize,0,2,2,0,0,0,0
2004,Benin,0,4,4,0,0,0,0
2004,Bermuda,0,10,7,0,0,0,0
2004,Bhutan,0,2,2,0,0,0,0
2004,Boliva,0,7,11,0,0,0,0
2004,Bosnia and Herzegovina,0,9,11,0,0,0,0
2004,Botswana,0,11,8,0,0,0,0
2004,Brunei,0,1,1,0,0,0,0
2004,Burkina Faso,0,5,5,0,0,0,0
2004,Burundi,0,7,5,0,0,0,0
2004,Cambodia,0,4,4,0,0,0,0
2004,Cape Verde,0,3,3,0,0,0,0
2004,Cayman Islands,0,5,8,0,0,0,0
2004,Central African Republic,0,4,4,0,0,0,0
2004,Chad,0,1,1,0,0,0,0
2004,Comoros,0,3,3,0,0,0,0
2004,Cook Islands,0,3,3,0,0,0,0
2004,Costa Rica,0,20,8,0,0,0,0
2004,Curacao,0,3,3,0,0,0,0
2004,Cyprus,0,20,20,0,0,0,0
2004,Democratic Republic of the Congo,0,4,4,0,0,0,0
2004,Dominica,0,2,2,0,0,0,0
2004,Ecuador,0,16,15,0,0,0,0
2004,El Salvador,0,7,9,0,0,0,0
2004,Equatorial Guinea,0,2,2,0,0,0,0
2004,Fiji,0,8,9,0,0,0,0
2004,Gabon,0,5,5,0,0,0,0
2004,Gambia,0,2,3,0,0,0,0
2004,Ghana,0,26,9,0,0,0,0
2004,Grenada,0,5,5,0,0,0,0
2004,Guam,0,4,4,0,0,0,0
2004,Guatemala,0,18,17,0,0,0,0
2004,Guinea,0,3,4,0,0,0,0
2004,Guinea-Bissau,0,3,3,0,0,0,0
2004,Guyana,0,4,4,0,0,0,0
2004,Haiti,0,8,8,0,0,0,0
2004,Honduras,0,5,5,0,0,0,0
2004,Iceland,0,26,20,0,0,0,0
2004,Iraq,0,24,8,0,0,0,0
2004,Ireland,0,46,31,0,0,0,0
2004,Ivory Coast,0,5,5,0,0,0,0
2004,Jordan,0,8,8,0,0,0,0
2004,Kiribati,0,3,3,0,0,0,0
2004,Kuwait,0,11,9,0,0,0,0
2004,Kyrgyzstan,0,29,32,0,0,0,0
2004,Laos,0,5,5,0,0,0,0
2004,Lebanon,0,5,5,0,0,0,0
2004,Lesotho,0,3,3,0,0,0,0
2004,Liberia,0,2,2,0,0,0,0
2004,Libya,0,8,8,0,0,0,0
2004,Liechtenstein,0,1,1,0,0,0,0
2004,Luxembourg,0,10,10,0,0,0,0
2004,Macedonia,0,10,14,0,0,0,0
2004,Madagascar,0,8,8,0,0,0,0
2004,Malawi,0,4,4,0,0,0,0
2004,Malaysia,0,26,31,0,0,0,0
2004,Maldives,0,4,4,0,0,0,0
2004,Mali,0,21,6,0,0,0,0
2004,Malta,0,7,7,0,0,0,0
2004,Mauritania,0,2,2,0,0,0,0
2004,Mauritius,0,9,9,0,0,0,0
2004,Micronesia,0,5,5,0,0,0,0
2004,Moldova,0,33,31,0,0,0,0
2004,Monaco,0,3,3,0,0,0,0
2004,Mozambique,0,4,4,0,0,0,0
2004,Myanmar,0,2,2,0,0,0,0
2004,Namibia,0,8,9,0,0,0,0
2004,Nauru,0,3,3,0,0,0,0
2004,Nepal,0,6,6,0,0,0,0
2004,Nicaragua,0,5,6,0,0,0,0
2004,Niger,0,4,4,0,0,0,0
2004,Oman,0,2,2,0,0,0,0
2004,Pakistan,0,26,11,0,0,0,0
2004,Palau,0,4,4,0,0,0,0
2004,Palestine,0,3,3,0,0,0,0
2004,Panama,0,4,5,0,0,0,0
2004,Papua New Guinea,0,4,6,0,0,0,0
2004,Peru,0,12,14,0,0,0,0
2004,Philippines,0,16,21,0,0,0,0
2004,Puerto Rico,0,43,38,0,0,0,0
2004,Qatar,0,15,14,0,0,0,0
2004,Republic of Congo,0,5,5,0,0,0,0
2004,Rwanda,0,5,5,0,0,0,0
2004,Saint Kitts,0,2,2,0,0,0,0
2004,Saint Lucia,0,2,2,0,0,0,0
2004,Saint Vincent,0,3,3,0,0,0,0
2004,Samoa,0,3,3,0,0,0,0
2004,San Marino,0,5,5,0,0,0,0
2004,Sao Tome and Principe,0,2,2,0,0,0,0
2004,Saudi Arabia,0,16,12,0,0,0,0
2004,Senegal,0,15,17,0,0,0,0
2004,Seychelles,0,9,10,0,0,0,0
2004,Sierra Leone,0,2,2,0,0,0,0
2004,Singapore,0,16,16,0,0,0,0
2004,Solomon Islands,0,2,2,0,0,0,0
2004,Somalia,0,2,2,0,0,0,0
2004,Sri Lanka,0,7,8,0,0,0,0
2004,Sudan,0,4,4,0,0,0,0
2004,Suriname,0,4,4,0,0,0,0
2004,Swaziland,0,3,3,0,0,0,0
2004,Tajikistan,0,9,9,0,0,0,0
2004,Tanzania,0,8,6,0,0,0,0
2004,Timor-Leste,0,2,2,0,0,0,0
2004,Togo,0,3,3,0,0,0,0
2004,Tonga,0,5,5,0,0,0,0
2004,Tunisia,0,54,37,0,0,0,0
2004,Turkmenistan,0,9,10,0,0,0,0
2004,Uganda,0,11,10,0,0,0,0
2004,Uruguay,0,15,16,0,0,0,0
2004,Vanuatu,0,2,2,0,0,0,0
2004,Vietnam,0,11,10,0,0,0,0
2004,"Virgin Islands, British",0,1,1,0,0,0,0
2004,"Virgin Islands, US",0,6,9,0,0,0,0
2004,Yemen,0,3,3,0,0,0,0
2004,Zambia,0,6,6,0,0,0,0
2008,USA,0,588,258,36,39,35,110
2008,China,1,617,259,51,21,28,100
2008,Russia,0,454,242,23,21,28,72
2008,UK,0,304,185,19,13,16,48
2008,Australia,0,432,219,14,15,17,46
2008,France,0,309,205,7,16,18,41
2008,Germany,0,420,207,16,10,15,41
2008,South Korea,0,263,142,13,10,8,31
2008,Italy,0,333,190,8,9,10,27
2008,Ukraine,0,243,177,7,5,15,27
2008,Japan,0,332,176,9,7,9,25
2008,Cuba,0,158,102,2,11,11,24
2008,Canada,0,332,185,3,9,7,19
2008,Belarus,0,177,122,4,5,9,18
2008,Spain,0,283,147,5,10,3,18
2008,Brazil,0,268,145,3,4,9,16
2008,Netherlands,0,237,98,7,5,4,16
2008,Kenya,0,46,24,6,4,5,15
2008,Kazakhstan,0,130,106,2,4,7,13
2008,Hungary,0,170,126,3,5,2,10
2008,Poland,0,257,165,3,6,1,10
2008,Jamaica,0,50,29,5,2,2,9
2008,New Zealand,0,178,78,3,2,4,9
2008,Norway,0,84,49,3,5,1,9
2008,Romania,0,101,80,4,1,3,8
2008,Azerbaijan,0,44,37,1,2,4,7
2008,Denmark,0,84,62,2,2,3,7
2008,Ethiopia,0,27,10,4,1,2,7
2008,Switzerland,0,83,75,2,1,4,7
2008,Turkey,0,67,67,1,3,3,7
2008,Argentina,0,132,71,2,0,4,6
2008,Armenia,0,25,24,0,0,6,6
2008,Czech Republic,0,134,105,3,3,0,6
2008,Georgia,0,35,35,3,0,3,6
2008,North Korea,0,58,38,2,1,3,6
2008,Slovakia,0,57,54,3,2,1,6
2008,Uzbekistan,0,56,67,1,2,3,6
2008,Bulgaria,0,70,60,1,1,3,5
2008,Croatia,0,99,66,0,2,3,5
2008,Indonesia,0,24,17,1,1,3,5
2008,Lithuania,0,71,54,0,2,3,5
2008,Slovenia,0,61,60,1,2,2,5
2008,Sweden,0,123,81,0,4,1,5
2008,Finland,0,57,55,1,1,2,4
2008,Greece,0,152,105,0,2,2,4
2008,Mongolia,0,28,29,2,2,0,4
2008,Nigeria,0,74,36,0,1,3,4
2008,Taiwan,0,79,41,0,0,4,4
2008,Thailand,0,47,43,2,2,0,4
2008,Zimbabwe,0,13,15,1,3,0,4
2008,Austria,0,70,62,0,1,2,3
2008,India,0,53,48,1,0,2,3
2008,Ireland,0,55,43,0,1,2,3
2008,Latvia,0,47,33,1,1,1,3
2008,Mexico,0,83,73,2,0,1,3
2008,Serbia,0,87,42,0,1,2,3
2008,Algeria,0,56,44,0,1,1,2
2008,Bahamas,0,25,22,0,1,1,2
2008,Belgium,0,94,55,1,1,0,2
2008,Colombia,0,67,74,0,1,1,2
2008,Dominican Republic,0,24,21,1,1,0,2
2008,Estonia,0,47,42,1,1,0,2
2008,Iran,0,54,40,1,0,1,2
2008,Kyrgyzstan,0,20,22,0,1,1,2
2008,Morocco,0,47,35,0,1,1,2
2008,Portugal,0,77,65,1,1,0,2
2008,Tajikistan,0,15,16,0,1,1,2
2008,Trinidad,0,28,19,1,1,0,2
2008,Afghanistan,0,4,4,0,0,1,1
2008,Cameroon,0,32,16,1,0,0,1
2008,Chile,0,26,26,0,1,0,1
2008,Ecuador,0,25,23,0,1,0,1
2008,Egypt,0,100,68,0,0,1,1
2008,Iceland,0,27,18,0,1,0,1
2008,Israel,0,43,47,0,0,1,1
2008,Malaysia,0,32,29,0,1,0,1
2008,Mauritius,0,11,11,0,0,1,1
2008,Moldova,0,29,28,0,0,1,1
2008,Panama,0,5,5,1,0,0,1
2008,Singapore,0,25,25,0,1,0,1
2008,South Africa,0,134,89,0,1,0,1
2008,Sudan,0,9,8,0,1,0,1
2008,Togo,0,4,4,0,0,1,1
2008,Tunisia,0,26,28,1,0,0,1
2008,Venezuela,0,108,83,0,0,1,1
2008,Vietnam,0,13,18,0,1,0,1
2008,Albania,0,11,12,0,0,0,0
2008,American Samoa,0,4,4,0,0,0,0
2008,Andorra,0,5,5,0,0,0,0
2008,Angola,0,32,8,0,0,0,0
2008,Antigua,0,5,5,0,0,0,0
2008,Aruba,0,2,2,0,0,0,0
2008,Bahrain,0,14,11,0,0,0,0
2008,Bangladesh,0,5,5,0,0,0,0
2008,Barbados,0,8,10,0,0,0,0
2008,Belize,0,4,4,0,0,0,0
2008,Benin,0,5,5,0,0,0,0
2008,Bermuda,0,6,6,0,0,0,0
2008,Bhutan,0,2,2,0,0,0,0
2008,Boliva,0,7,7,0,0,0,0
2008,Bosnia and Herzegovina,0,5,7,0,0,0,0
2008,Botswana,0,11,11,0,0,0,0
2008,Burkina Faso,0,6,6,0,0,0,0
2008,Burundi,0,3,3,0,0,0,0
2008,Cambodia,0,4,4,0,0,0,0
2008,Cape Verde,0,2,2,0,0,0,0
2008,Cayman Islands,0,4,6,0,0,0,0
2008,Central African Republic,0,3,3,0,0,0,0
2008,Chad,0,2,2,0,0,0,0
2008,Comoros,0,3,3,0,0,0,0
2008,Cook Islands,0,4,4,0,0,0,0
2008,Costa Rica,0,8,8,0,0,0,0
2008,Curacao,0,3,4,0,0,0,0
2008,Cyprus,0,17,17,0,0,0,0
2008,Democratic Republic of the Congo,0,5,5,0,0,0,0
2008,Djibouti,0,2,2,0,0,0,0
2008,Dominica,0,2,2,0,0,0,0
2008,El Salvador,0,11,14,0,0,0,0
2008,Equatorial Guinea,0,3,3,0,0,0,0
2008,Eritrea,0,10,6,0,0,0,0
2008,Fiji,0,6,6,0,0,0,0
2008,Gabon,0,4,4,0,0,0,0
2008,Gambia,0,3,3,0,0,0,0
2008,Ghana,0,9,9,0,0,0,0
2008,Grenada,0,9,8,0,0,0,0
2008,Guam,0,6,7,0,0,0,0
2008,Guatemala,0,12,12,0,0,0,0
2008,Guinea,0,5,5,0,0,0,0
2008,Guinea-Bissau,0,3,3,0,0,0,0
2008,Guyana,0,4,4,0,0,0,0
2008,Haiti,0,7,7,0,0,0,0
2008,Honduras,0,25,8,0,0,0,0
2008,Iraq,0,4,3,0,0,0,0
2008,Ivory Coast,0,21,7,0,0,0,0
2008,Jordan,0,7,7,0,0,0,0
2008,Kiribati,0,2,2,0,0,0,0
2008,Kuwait,0,8,7,0,0,0,0
2008,Laos,0,4,4,0,0,0,0
2008,Lebanon,0,6,6,0,0,0,0
2008,Lesotho,0,5,3,0,0,0,0
2008,Liberia,0,3,4,0,0,0,0
2008,Libya,0,6,6,0,0,0,0
2008,Liechtenstein,0,2,2,0,0,0,0
2008,Luxembourg,0,13,17,0,0,0,0
2008,Macedonia,0,7,7,0,0,0,0
2008,Madagascar,0,6,6,0,0,0,0
2008,Malawi,0,4,4,0,0,0,0
2008,Maldives,0,4,4,0,0,0,0
2008,Mali,0,17,6,0,0,0,0
2008,Malta,0,6,6,0,0,0,0
2008,Marshall Islands,0,5,5,0,0,0,0
2008,Mauritania,0,2,2,0,0,0,0
2008,Micronesia,0,5,5,0,0,0,0
2008,Monaco,0,5,5,0,0,0,0
2008,Montenegro,0,19,8,0,0,0,0
2008,Mozambique,0,4,4,0,0,0,0
2008,Myanmar,0,6,7,0,0,0,0
2008,Namibia,0,10,10,0,0,0,0
2008,Nauru,0,1,1,0,0,0,0
2008,Nepal,0,8,8,0,0,0,0
2008,Nicaragua,0,6,7,0,0,0,0
2008,Niger,0,4,4,0,0,0,0
2008,Oman,0,4,4,0,0,0,0
2008,Pakistan,0,21,7,0,0,0,0
2008,Palau,0,5,5,0,0,0,0
2008,Palestine,0,4,4,0,0,0,0
2008,Papua New Guinea,0,7,9,0,0,0,0
2008,Paraguay,0,7,7,0,0,0,0
2008,Peru,0,13,13,0,0,0,0
2008,Philippines,0,15,17,0,0,0,0
2008,Puerto Rico,0,22,31,0,0,0,0
2008,Qatar,0,20,14,0,0,0,0
2008,Republic of Congo,0,5,5,0,0,0,0
2008,Rwanda,0,4,4,0,0,0,0
2008,Saint Kitts,0,4,5,0,0,0,0
2008,Saint Lucia,0,4,4,0,0,0,0
2008,Saint Vincent,0,2,2,0,0,0,0
2008,Samoa,0,6,7,0,0,0,0
2008,San Marino,0,4,4,0,0,0,0
2008,Sao Tome and Principe,0,3,4,0,0,0,0
2008,Saudi Arabia,0,14,11,0,0,0,0
2008,Senegal,0,15,16,0,0,0,0
2008,Seychelles,0,9,9,0,0,0,0
2008,Sierra Leone,0,3,3,0,0,0,0
2008,Solomon Islands,0,3,3,0,0,0,0
2008,Somalia,0,2,2,0,0,0,0
2008,Sri Lanka,0,8,9,0,0,0,0
2008,Suriname,0,4,4,0,0,0,0
2008,Swaziland,0,4,4,0,0,0,0
2008,Syria,0,7,7,0,0,0,0
2008,Tanzania,0,9,6,0,0,0,0
2008,Timor-Leste,0,1,1,0,0,0,0
2008,Tonga,0,3,3,0,0,0,0
2008,Turkmenistan,0,10,9,0,0,0,0
2008,Uganda,0,11,10,0,0,0,0
2008,United Arab Emirates,0,8,9,0,0,0,0
2008,Uruguay,0,12,12,0,0,0,0
2008,Vanuatu,0,3,3,0,0,0,0
2008,"Virgin Islands, British",0,2,2,0,0,0,0
2008,"Virgin Islands, US",0,7,8,0,0,0,0
2008,Yemen,0,5,8,0,0,0,0
2008,Zambia,0,8,8,0,0,0,0
2012,USA,0,529,245,46,28,29,103
2012,China,0,406,212,38,27,24,89
2012,Russia,0,429,238,24,26,32,82
2012,UK,1,530,249,29,17,19,65
2012,Germany,0,383,213,11,19,14,44
2012,Japan,0,291,178,7,14,17,38
2012,Australia,0,405,208,7,16,12,35
2012,France,0,324,188,11,11,13,35
2012,Italy,0,281,169,8,9,11,28
2012,South Korea,0,249,140,13,8,7,28
2012,Netherlands,0,173,95,6,6,8,20
2012,Ukraine,0,230,174,6,5,9,20
2012,Canada,0,273,179,1,5,12,18
2012,Hungary,0,151,111,8,4,6,18
2012,Brazil,0,248,138,3,5,9,17
2012,Spain,0,278,135,3,10,4,17
2012,Cuba,0,109,86,5,3,6,14
2012,Kazakhstan,0,113,106,7,1,5,13
2012,New Zealand,0,178,87,6,2,5,13
2012,Belarus,0,160,110,2,5,5,12
2012,Iran,0,52,51,4,5,3,12
2012,Jamaica,0,45,25,4,4,4,12
2012,Kenya,0,47,23,2,4,5,11
2012,Azerbaijan,0,52,57,2,2,6,10
2012,Czech Republic,0,133,99,4,3,3,10
2012,Poland,0,210,148,2,2,6,10
2012,Denmark,0,114,69,2,4,3,9
2012,Romania,0,105,75,2,5,2,9
2012,Colombia,0,101,81,1,3,4,8
2012,Sweden,0,133,81,1,4,3,8
2012,Ethiopia,0,33,14,3,1,3,7
2012,Georgia,0,34,35,1,3,3,7
2012,Mexico,0,99,75,1,3,3,7
2012,Croatia,0,107,53,3,1,2,6
2012,India,0,81,55,0,2,4,6
2012,North Korea,0,51,27,4,0,2,6
2012,South Africa,0,124,65,3,2,1,6
2012,Ireland,0,64,54,1,1,3,5
2012,Lithuania,0,62,54,2,1,2,5
2012,Mongolia,0,29,32,0,2,3,5
2012,Turkey,0,112,80,2,2,1,5
2012,Argentina,0,137,66,1,1,2,4
2012,Norway,0,61,46,2,1,1,4
2012,Serbia,0,116,55,1,1,2,4
2012,Slovakia,0,47,52,0,1,3,4
2012,Slovenia,0,65,68,1,1,2,4
2012,Switzerland,0,98,71,2,2,0,4
2012,Trinidad,0,25,22,1,1,2,4
2012,Armenia,0,24,30,0,1,2,3
2012,Belgium,0,111,71,0,1,2,3
2012,Finland,0,56,61,0,1,2,3
2012,Thailand,0,37,37,0,2,1,3
2012,Tunisia,0,83,50,1,1,1,3
2012,Uzbekistan,0,53,52,1,0,2,3
2012,Bulgaria,0,63,56,0,1,1,2
2012,Dominican Republic,0,33,21,1,1,0,2
2012,Egypt,0,109,87,0,2,0,2
2012,Estonia,0,32,30,0,1,1,2
2012,Greece,0,102,76,0,0,2,2
2012,Indonesia,0,22,16,0,1,1,2
2012,Latvia,0,45,38,1,0,1,2
2012,Malaysia,0,29,25,0,1,1,2
2012,Moldova,0,20,19,0,0,2,2
2012,Puerto Rico,0,25,25,0,1,1,2
2012,Qatar,0,12,13,0,0,2,2
2012,Singapore,0,23,29,0,0,2,2
2012,Taiwan,0,44,40,0,1,1,2
2012,Afghanistan,0,6,6,0,0,1,1
2012,Algeria,0,38,29,1,0,0,1
2012,Bahamas,0,21,16,1,0,0,1
2012,Bahrain,0,12,11,0,0,1,1
2012,Botswana,0,4,4,0,1,0,1
2012,Cyprus,0,13,12,0,1,0,1
2012,Gabon,0,21,7,0,1,0,1
2012,Grenada,0,8,8,1,0,0,1
2012,Guatemala,0,19,21,0,1,0,1
2012,Kuwait,0,10,11,0,0,1,1
2012,Montenegro,0,33,9,0,1,0,1
2012,Morocco,0,63,40,0,0,1,1
2012,Portugal,0,76,75,0,1,0,1
2012,Saudi Arabia,0,18,14,0,0,1,1
2012,Tajikistan,0,16,16,0,0,1,1
2012,Uganda,0,15,12,1,0,0,1
2012,Venezuela,0,68,70,1,0,0,1
2012,Albania,0,9,9,0,0,0,0
2012,American Samoa,0,4,4,0,0,0,0
2012,Andorra,0,6,6,0,0,0,0
2012,Angola,0,33,10,0,0,0,0
2012,Antigua,0,4,4,0,0,0,0
2012,Aruba,0,4,4,0,0,0,0
2012,Austria,0,70,69,0,0,0,0
2012,Bangladesh,0,5,7,0,0,0,0
2012,Barbados,0,6,6,0,0,0,0
2012,Belize,0,3,3,0,0,0,0
2012,Benin,0,5,5,0,0,0,0
2012,Bermuda,0,8,7,0,0,0,0
2012,Bhutan,0,2,2,0,0,0,0
2012,Boliva,0,5,5,0,0,0,0
2012,Bosnia and Herzegovina,0,6,8,0,0,0,0
2012,Brunei,0,3,3,0,0,0,0
2012,Burkina Faso,0,5,5,0,0,0,0
2012,Burundi,0,6,6,0,0,0,0
2012,Cambodia,0,6,6,0,0,0,0
2012,Cameroon,0,32,16,0,0,0,0
2012,Cape Verde,0,3,3,0,0,0,0
2012,Cayman Islands,0,4,5,0,0,0,0
2012,Central African Republic,0,6,6,0,0,0,0
2012,Chad,0,2,2,0,0,0,0
2012,Chile,0,35,36,0,0,0,0
2012,Comoros,0,3,3,0,0,0,0
2012,Cook Islands,0,8,9,0,0,0,0
2012,Costa Rica,0,11,11,0,0,0,0
2012,Democratic Republic of the Congo,0,4,4,0,0,0,0
2012,Djibouti,0,4,4,0,0,0,0
2012,Dominica,0,2,2,0,0,0,0
2012,Ecuador,0,36,34,0,0,0,0
2012,El Salvador,0,10,11,0,0,0,0
2012,Equatorial Guinea,0,2,2,0,0,0,0
2012,Eritrea,0,12,7,0,0,0,0
2012,Fiji,0,9,9,0,0,0,0
2012,Gambia,0,2,2,0,0,0,0
2012,Ghana,0,7,7,0,0,0,0
2012,Guam,0,8,8,0,0,0,0
2012,Guinea,0,4,4,0,0,0,0
2012,Guinea-Bissau,0,4,4,0,0,0,0
2012,Guyana,0,6,6,0,0,0,0
2012,Haiti,0,5,5,0,0,0,0
2012,Honduras,0,25,10,0,0,0,0
2012,Iceland,0,27,20,0,0,0,0
2012,Individual Olympic Athletes,0,4,4,0,0,0,0
2012,Iraq,0,8,8,0,0,0,0
2012,Israel,0,37,41,0,0,0,0
2012,Ivory Coast,0,9,10,0,0,0,0
2012,Jordan,0,9,9,0,0,0,0
2012,Kiribati,0,3,3,0,0,0,0
2012,Kyrgyzstan,0,14,15,0,0,0,0
2012,Laos,0,3,3,0,0,0,0
2012,Lebanon,0,10,10,0,0,0,0
2012,Lesotho,0,4,4,0,0,0,0
2012,Liberia,0,3,3,0,0,0,0
2012,Libya,0,4,4,0,0,0,0
2012,Liechtenstein,0,3,4,0,0,0,0
2012,Luxembourg,0,9,11,0,0,0,0
2012,Macedonia,0,4,4,0,0,0,0
2012,Madagascar,0,7,7,0,0,0,0
2012,Malawi,0,3,3,0,0,0,0
2012,Maldives,0,5,5,0,0,0,0
2012,Mali,0,6,6,0,0,0,0
2012,Malta,0,5,5,0,0,0,0
2012,Marshall Islands,0,4,4,0,0,0,0
2012,Mauritania,0,2,2,0,0,0,0
2012,Mauritius,0,11,10,0,0,0,0
2012,Micronesia,0,6,6,0,0,0,0
2012,Monaco,0,6,6,0,0,0,0
2012,Mozambique,0,6,6,0,0,0,0
2012,Myanmar,0,6,6,0,0,0,0
2012,Namibia,0,9,8,0,0,0,0
2012,Nauru,0,2,2,0,0,0,0
2012,Nepal,0,5,5,0,0,0,0
2012,Nicaragua,0,6,6,0,0,0,0
2012,Niger,0,6,6,0,0,0,0
2012,Nigeria,0,49,31,0,0,0,0
2012,Oman,0,3,3,0,0,0,0
2012,Pakistan,0,20,6,0,0,0,0
2012,Palau,0,5,5,0,0,0,0
2012,Palestine,0,5,5,0,0,0,0
2012,Panama,0,8,8,0,0,0,0
2012,Papua New Guinea,0,8,8,0,0,0,0
2012,Paraguay,0,8,10,0,0,0,0
2012,Peru,0,16,14,0,0,0,0
2012,Philippines,0,11,11,0,0,0,0
2012,Republic of Congo,0,7,6,0,0,0,0
2012,Rwanda,0,7,7,0,0,0,0
2012,Saint Kitts,0,4,3,0,0,0,0
2012,Saint Lucia,0,4,4,0,0,0,0
2012,Saint Vincent,0,3,3,0,0,0,0
2012,Samoa,0,8,9,0,0,0,0
2012,San Marino,0,4,4,0,0,0,0
2012,Sao Tome and Principe,0,2,2,0,0,0,0
2012,Senegal,0,31,16,0,0,0,0
2012,Seychelles,0,6,6,0,0,0,0
2012,Sierra Leone,0,2,2,0,0,0,0
2012,Solomon Islands,0,4,4,0,0,0,0
2012,Somalia,0,2,2,0,0,0,0
2012,Sri Lanka,0,7,8,0,0,0,0
2012,Sudan,0,6,5,0,0,0,0
2012,Suriname,0,5,5,0,0,0,0
2012,Swaziland,0,3,3,0,0,0,0
2012,Syria,0,10,10,0,0,0,0
2012,Tanzania,0,6,5,0,0,0,0
2012,Timor-Leste,0,2,2,0,0,0,0
2012,Togo,0,6,6,0,0,0,0
2012,Tonga,0,3,3,0,0,0,0
2012,Turkmenistan,0,10,10,0,0,0,0
2012,United Arab Emirates,0,26,9,0,0,0,0
2012,Uruguay,0,27,11,0,0,0,0
2012,Vanuatu,0,5,5,0,0,0,0
2012,Vietnam,0,18,23,0,0,0,0
2012,"Virgin Islands, British",0,2,2,0,0,0,0
2012,"Virgin Islands, US",0,7,7,0,0,0,0
2012,Yemen,0,4,4,0,0,0,0
2012,Zambia,0,7,7,0,0,0,0
2012,Zimbabwe,0,7,8,0,0,0,0
2016,USA,0,555,245,46,37,38,121
2016,China,0,427,211,26,18,26,70
2016,UK,0,360,198,27,23,17,67
2016,Russia,0,284,181,19,17,20,56
2016,France,0,392,202,10,18,14,42
2016,Germany,0,418,217,17,10,15,42
2016,Japan,0,335,186,12,8,21,41
2016,Australia,0,420,194,8,11,10,29
2016,Italy,0,309,171,8,12,8,28
2016,Canada,0,310,175,4,3,15,22
2016,South Korea,0,207,117,9,3,9,21
2016,Brazil,1,462,222,7,6,6,19
2016,Netherlands,0,237,122,8,7,4,19
2016,Azerbaijan,0,56,62,1,7,10,18
2016,Kazakhstan,0,101,98,3,5,10,18
2016,New Zealand,0,195,100,4,9,5,18
2016,Spain,0,307,146,7,4,6,17
2016,Denmark,0,119,67,2,6,7,15
2016,Hungary,0,153,113,8,3,4,15
2016,Kenya,0,79,29,6,6,1,13
2016,Uzbekistan,0,70,69,4,2,7,13
2016,Cuba,0,117,99,5,2,4,11
2016,Jamaica,0,56,32,6,3,2,11
2016,Poland,0,234,144,2,3,6,11
2016,Sweden,0,150,79,2,6,3,11
2016,Ukraine,0,204,142,2,5,4,11
2016,Croatia,0,85,47,5,3,2,10
2016,Czech Republic,0,104,92,1,2,7,10
2016,South Africa,0,135,70,2,6,2,10
2016,Belarus,0,120,86,1,4,4,9
2016,Colombia,0,143,85,3,2,3,8
2016,Ethiopia,0,37,16,1,2,5,8
2016,Iran,0,63,46,3,1,4,8
2016,Serbia,0,103,56,2,4,2,8
2016,Turkey,0,100,88,1,3,4,8
2016,Georgia,0,40,40,2,1,4,7
2016,North Korea,0,30,28,2,3,2,7
2016,Switzerland,0,102,80,3,2,2,7
2016,Belgium,0,104,74,2,2,2,6
2016,Greece,0,92,65,3,1,2,6
2016,Thailand,0,54,45,2,2,2,6
2016,Malaysia,0,32,29,0,4,1,5
2016,Mexico,0,123,80,0,3,2,5
2016,Argentina,0,215,80,3,1,0,4
2016,Armenia,0,31,32,1,3,0,4
2016,Lithuania,0,67,49,0,1,3,4
2016,Norway,0,62,53,0,0,4,4
2016,Romania,0,95,62,1,1,2,4
2016,Slovakia,0,51,49,2,2,0,4
2016,Slovenia,0,63,45,1,2,1,4
2016,Bulgaria,0,51,51,0,1,2,3
2016,Egypt,0,121,87,0,0,3,3
2016,Indonesia,0,28,20,1,2,0,3
2016,Taiwan,0,55,46,1,0,2,3
2016,Tunisia,0,61,47,0,0,3,3
2016,Venezuela,0,85,77,0,1,2,3
2016,Algeria,0,64,48,0,2,0,2
2016,Bahamas,0,29,20,1,0,1,2
2016,Bahrain,0,33,20,1,1,0,2
2016,India,0,112,67,0,1,1,2
2016,Individual Olympic Athletes,0,9,6,1,0,1,2
2016,Ireland,0,76,57,0,2,0,2
2016,Israel,0,47,45,0,0,2,2
2016,Ivory Coast,0,12,12,1,0,1,2
2016,Mongolia,0,43,41,0,1,1,2
2016,Vietnam,0,22,24,1,1,0,2
2016,Austria,0,71,61,0,0,1,1
2016,Burundi,0,9,9,0,1,0,1
2016,Dominican Republic,0,26,22,0,0,1,1
2016,Estonia,0,46,31,0,0,1,1
2016,Fiji,0,53,14,1,0,0,1
2016,Finland,0,54,55,0,0,1,1
2016,Grenada,0,6,4,0,1,0,1
2016,Jordan,0,8,8,1,0,0,1
2016,Kosovo,0,8,8,1,0,0,1
2016,Morocco,0,48,39,0,0,1,1
2016,Niger,0,6,6,0,1,0,1
2016,Nigeria,0,71,36,0,0,1,1
2016,Philippines,0,13,13,0,1,0,1
2016,Portugal,0,90,61,0,0,1,1
2016,Puerto Rico,0,40,27,1,0,0,1
2016,Qatar,0,37,20,0,1,0,1
2016,Singapore,0,25,24,1,0,0,1
2016,Tajikistan,0,7,7,1,0,0,1
2016,Trinidad,0,28,24,0,0,1,1
2016,United Arab Emirates,0,12,11,0,0,1,1
2016,Afghanistan,0,3,3,0,0,0,0
2016,Albania,0,6,6,0,0,0,0
2016,American Samoa,0,4,4,0,0,0,0
2016,Andorra,0,4,4,0,0,0,0
2016,Angola,0,26,10,0,0,0,0
2016,Antigua,0,8,5,0,0,0,0
2016,Aruba,0,7,6,0,0,0,0
2016,Bangladesh,0,7,7,0,0,0,0
2016,Barbados,0,11,11,0,0,0,0
2016,Belize,0,3,3,0,0,0,0
2016,Benin,0,6,6,0,0,0,0
2016,Bermuda,0,8,8,0,0,0,0
2016,Bhutan,0,2,2,0,0,0,0
2016,Boliva,0,12,10,0,0,0,0
2016,Bosnia and Herzegovina,0,11,8,0,0,0,0
2016,Botswana,0,12,7,0,0,0,0
2016,Brunei,0,3,3,0,0,0,0
2016,Burkina Faso,0,5,5,0,0,0,0
2016,Cambodia,0,6,6,0,0,0,0
2016,Cameroon,0,22,13,0,0,0,0
2016,Cape Verde,0,5,5,0,0,0,0
2016,Cayman Islands,0,5,5,0,0,0,0
2016,Central African Republic,0,6,6,0,0,0,0
2016,Chad,0,2,2,0,0,0,0
2016,Chile,0,42,36,0,0,0,0
2016,Comoros,0,4,4,0,0,0,0
2016,Cook Islands,0,9,9,0,0,0,0
2016,Costa Rica,0,11,11,0,0,0,0
2016,Cyprus,0,15,19,0,0,0,0
2016,Democratic Republic of the Congo,0,4,4,0,0,0,0
2016,Djibouti,0,7,7,0,0,0,0
2016,Dominica,0,2,2,0,0,0,0
2016,Ecuador,0,37,29,0,0,0,0
2016,El Salvador,0,8,10,0,0,0,0
2016,Equatorial Guinea,0,1,1,0,0,0,0
2016,Eritrea,0,12,6,0,0,0,0
2016,Gabon,0,6,6,0,0,0,0
2016,Gambia,0,4,4,0,0,0,0
2016,Ghana,0,13,12,0,0,0,0
2016,Guam,0,5,5,0,0,0,0
2016,Guatemala,0,21,19,0,0,0,0
2016,Guinea,0,5,5,0,0,0,0
2016,Guinea-Bissau,0,5,5,0,0,0,0
2016,Guyana,0,6,7,0,0,0,0
2016,Haiti,0,10,10,0,0,0,0
2016,Honduras,0,23,8,0,0,0,0
2016,Iceland,0,8,14,0,0,0,0
2016,Iraq,0,20,5,0,0,0,0
2016,Kiribati,0,3,3,0,0,0,0
2016,Kyrgyzstan,0,19,17,0,0,0,0
2016,Laos,0,5,5,0,0,0,0
2016,Latvia,0,32,25,0,0,0,0
2016,Lebanon,0,9,9,0,0,0,0
2016,Lesotho,0,8,8,0,0,0,0
2016,Liberia,0,2,3,0,0,0,0
2016,Libya,0,7,7,0,0,0,0
2016,Liechtenstein,0,3,3,0,0,0,0
2016,Luxembourg,0,10,14,0,0,0,0
2016,Macedonia,0,6,6,0,0,0,0
2016,Madagascar,0,6,6,0,0,0,0
2016,Malawi,0,5,5,0,0,0,0
2016,Maldives,0,4,4,0,0,0,0
2016,Mali,0,6,6,0,0,0,0
2016,Malta,0,7,8,0,0,0,0
2016,Marshall Islands,0,5,5,0,0,0,0
2016,Mauritania,0,2,2,0,0,0,0
2016,Mauritius,0,11,11,0,0,0,0
2016,Micronesia,0,5,5,0,0,0,0
2016,Moldova,0,23,22,0,0,0,0
2016,Monaco,0,3,8,0,0,0,0
2016,Montenegro,0,35,9,0,0,0,0
2016,Mozambique,0,6,7,0,0,0,0
2016,Myanmar,0,7,8,0,0,0,0
2016,Namibia,0,10,9,0,0,0,0
2016,Nauru,0,2,2,0,0,0,0
2016,Nepal,0,7,7,0,0,0,0
2016,Nicaragua,0,5,5,0,0,0,0
2016,Oman,0,4,4,0,0,0,0
2016,Pakistan,0,7,7,0,0,0,0
2016,Palau,0,5,6,0,0,0,0
2016,Palestine,0,6,6,0,0,0,0
2016,Panama,0,10,14,0,0,0,0
2016,Papua New Guinea,0,8,8,0,0,0,0
2016,Paraguay,0,11,11,0,0,0,0
2016,Peru,0,29,28,0,0,0,0
2016,Republic of Congo,0,10,9,0,0,0,0
2016,Rwanda,0,7,7,0,0,0,0
2016,Saint Kitts,0,6,4,0,0,0,0
2016,Saint Lucia,0,5,4,0,0,0,0
2016,Saint Vincent,0,4,4,0,0,0,0
2016,Samoa,0,8,9,0,0,0,0
2016,San Marino,0,4,3,0,0,0,0
2016,Sao Tome and Principe,0,3,3,0,0,0,0
2016,Saudi Arabia,0,10,10,0,0,0,0
2016,Senegal,0,22,11,0,0,0,0
2016,Seychelles,0,10,10,0,0,0,0
2016,Sierra Leone,0,4,4,0,0,0,0
2016,Solomon Islands,0,3,3,0,0,0,0
2016,Somalia,0,2,2,0,0,0,0
2016,South Sudan,0,3,3,0,0,0,0
2016,Sri Lanka,0,9,10,0,0,0,0
2016,Sudan,0,6,6,0,0,0,0
2016,Suriname,0,6,6,0,0,0,0
2016,Swaziland,0,2,2,0,0,0,0
2016,Syria,0,7,7,0,0,0,0
2016,Tanzania,0,7,5,0,0,0,0
2016,Timor-Leste,0,3,3,0,0,0,0
2016,Togo,0,5,5,0,0,0,0
2016,Tonga,0,7,7,0,0,0,0
2016,Turkmenistan,0,9,9,0,0,0,0
2016,Uganda,0,21,14,0,0,0,0
2016,Uruguay,0,17,14,0,0,0,0
2016,Vanuatu,0,4,4,0,0,0,0
2016,"Virgin Islands, British",0,4,4,0,0,0,0
2016,"Virgin Islands, US",0,7,7,0,0,0,0
2016,Yemen,0,3,3,0,0,0,0
2016,Zambia,0,7,7,0,0,0,0
2016,Zimbabwe,0,30,13,0,0,0,0
2020,USA,0,633,245,35,41,33,109
2020,China,0,462,215,38,32,21,91
2020,Russia,0,341,202,20,25,23,68
2020,UK,0,392,197,22,21,22,65
2020,Japan,1,613,222,27,14,16,57
2020,Australia,0,489,193,16,7,22,45
2020,Italy,0,379,198,10,10,20,40
2020,Germany,0,415,206,10,11,16,37
2020,Netherlands,0,283,123,10,12,14,36
2020,France,0,396,194,9,12,11,32
2020,Canada,0,386,182,7,6,11,24
2020,Brazil,0,319,142,7,6,8,21
2020,Hungary,0,171,110,6,7,7,20
2020,New Zealand,0,228,90,7,6,7,20
2020,South Korea,0,237,120,6,4,10,20
2020,Ukraine,0,153,121,1,6,12,19
2020,Spain,0,336,146,3,8,6,17
2020,Cuba,0,69,64,7,3,5,15
2020,Poland,0,218,137,4,5,5,14
2020,Switzerland,0,116,96,3,4,6,13
2020,Turkey,0,107,94,2,2,9,13
2020,Taiwan,0,68,61,2,4,6,12
2020,Czech Republic,0,115,89,4,4,3,11
2020,Denmark,0,108,63,3,4,4,11
2020,Kenya,0,87,26,4,4,2,10
2020,Jamaica,0,61,32,4,1,4,9
2020,Serbia,0,87,47,3,1,5,9
2020,Sweden,0,136,77,3,6,0,9
2020,Croatia,0,60,47,3,3,2,8
2020,Georgia,0,35,35,2,5,1,8
2020,Kazakhstan,0,97,82,0,0,8,8
2020,Norway,0,93,60,4,2,2,8
2020,Austria,0,76,70,1,1,5,7
2020,Azerbaijan,0,44,51,0,3,4,7
2020,Belarus,0,103,89,1,3,3,7
2020,Belgium,0,130,77,3,1,3,7
2020,India,0,126,72,1,2,4,7
2020,Iran,0,65,44,3,2,2,7
2020,Bulgaria,0,42,45,3,1,2,6
2020,Egypt,0,141,94,1,1,4,6
2020,Colombia,0,69,56,0,4,1,5
2020,Dominican Republic,0,66,31,0,3,2,5
2020,Indonesia,0,28,23,1,1,3,5
2020,Slovenia,0,53,43,3,1,1,5
2020,Uzbekistan,0,67,69,3,0,2,5
2020,Armenia,0,17,19,0,2,2,4
2020,Ethiopia,0,37,15,1,1,2,4
2020,Greece,0,82,58,2,1,1,4
2020,Ireland,0,125,76,2,0,2,4
2020,Israel,0,90,68,2,0,2,4
2020,Mexico,0,162,87,0,0,4,4
2020,Mongolia,0,43,43,0,1,3,4
2020,Philippines,0,19,26,1,2,1,4
2020,Portugal,0,93,65,1,1,2,4
2020,Romania,0,104,57,1,3,0,4
2020,Slovakia,0,41,42,1,2,1,4
2020,Uganda,0,25,18,2,1,1,4
2020,Venezuela,0,43,35,1,3,0,4
2020,Ecuador,0,47,35,2,1,0,3
2020,Kyrgyzstan,0,16,17,0,2,1,3
2020,Qatar,0,16,15,2,0,1,3
2020,San Marino,0,5,7,0,1,2,3
2020,South Africa,0,181,73,1,2,0,3
2020,Argentina,0,189,61,0,1,1,2
2020,Bahamas,0,16,12,2,0,0,2
2020,Estonia,0,33,28,1,0,1,2
2020,Fiji,0,32,8,1,0,1,2
2020,Finland,0,45,37,0,0,2,2
2020,Jordan,0,14,15,0,1,1,2
2020,Kosovo,0,11,11,2,0,0,2
2020,Latvia,0,33,26,1,0,1,2
2020,Malaysia,0,30,37,0,1,1,2
2020,Nigeria,0,53,31,0,1,1,2
2020,Thailand,0,41,33,1,0,1,2
2020,Tunisia,0,63,50,1,1,0,2
2020,Bahrain,0,32,14,0,1,0,1
2020,Bermuda,0,2,2,1,0,0,1
2020,Botswana,0,14,9,0,0,1,1
2020,Burkina Faso,0,7,8,0,0,1,1
2020,Ghana,0,14,11,0,0,1,1
2020,Grenada,0,6,6,0,0,1,1
2020,Ivory Coast,0,31,11,0,0,1,1
2020,Kuwait,0,10,8,0,0,1,1
2020,Lithuania,0,42,46,0,1,0,1
2020,Macedonia,0,8,8,0,1,0,1
2020,Moldova,0,20,23,0,0,1,1
2020,Morocco,0,46,37,1,0,0,1
2020,Namibia,0,11,10,0,1,0,1
2020,Puerto Rico,0,37,24,1,0,0,1
2020,Saudi Arabia,0,33,12,0,1,0,1
2020,Syria,0,6,6,0,0,1,1
2020,Turkmenistan,0,9,10,0,1,0,1
2020,Afghanistan,0,5,5,0,0,0,0
2020,Albania,0,9,10,0,0,0,0
2020,Algeria,0,41,43,0,0,0,0
2020,American Samoa,0,6,5,0,0,0,0
2020,Andorra,0,2,3,0,0,0,0
2020,Angola,0,20,6,0,0,0,0
2020,Antigua,0,6,6,0,0,0,0
2020,Aruba,0,3,4,0,0,0,0
2020,Bangladesh,0,6,7,0,0,0,0
2020,Barbados,0,8,9,0,0,0,0
2020,Belize,0,3,4,0,0,0,0
2020,Benin,0,7,7,0,0,0,0
2020,Bhutan,0,4,4,0,0,0,0
2020,Boliva,0,5,5,0,0,0,0
2020,Bosnia and Herzegovina,0,7,8,0,0,0,0
2020,Brunei,0,2,2,0,0,0,0
2020,Burundi,0,6,7,0,0,0,0
2020,Cambodia,0,3,3,0,0,0,0
2020,Cameroon,0,12,12,0,0,0,0
2020,Cape Verde,0,6,6,0,0,0,0
2020,Cayman Islands,0,5,9,0,0,0,0
2020,Central African Republic,0,2,2,0,0,0,0
2020,Chad,0,3,3,0,0,0,0
2020,Chile,0,57,34,0,0,0,0
2020,Comoros,0,3,3,0,0,0,0
2020,Cook Islands,0,6,9,0,0,0,0
2020,Costa Rica,0,14,17,0,0,0,0
2020,Cyprus,0,15,22,0,0,0,0
2020,Democratic Republic of the Congo,0,7,7,0,0,0,0
2020,Djibouti,0,4,5,0,0,0,0
2020,Dominica,0,2,2,0,0,0,0
2020,El Salvador,0,5,7,0,0,0,0
2020,Equatorial Guinea,0,3,3,0,0,0,0
2020,Eritrea,0,13,10,0,0,0,0
2020,Gabon,0,5,5,0,0,0,0
2020,Gambia,0,4,5,0,0,0,0
2020,Guam,0,5,5,0,0,0,0
2020,Guatemala,0,24,17,0,0,0,0
2020,Guinea,0,5,5,0,0,0,0
2020,Guinea-Bissau,0,4,4,0,0,0,0
2020,Guyana,0,7,7,0,0,0,0
2020,Haiti,0,6,6,0,0,0,0
2020,Honduras,0,27,7,0,0,0,0
2020,Iceland,0,4,5,0,0,0,0
2020,Iraq,0,3,3,0,0,0,0
2020,Kiribati,0,3,3,0,0,0,0
2020,Laos,0,4,4,0,0,0,0
2020,Lebanon,0,6,6,0,0,0,0
2020,Lesotho,0,2,2,0,0,0,0
2020,Liberia,0,3,3,0,0,0,0
2020,Libya,0,4,4,0,0,0,0
2020,Liechtenstein,0,5,8,0,0,0,0
2020,Luxembourg,0,12,11,0,0,0,0
2020,Madagascar,0,6,6,0,0,0,0
2020,Malawi,0,5,5,0,0,0,0
2020,Maldives,0,4,4,0,0,0,0
2020,Mali,0,4,4,0,0,0,0
2020,Malta,0,6,8,0,0,0,0
2020,Marshall Islands,0,2,2,0,0,0,0
2020,Mauritania,0,2,2,0,0,0,0
2020,Mauritius,0,8,8,0,0,0,0
2020,Micronesia,0,3,3,0,0,0,0
2020,Monaco,0,6,6,0,0,0,0
2020,Montenegro,0,35,9,0,0,0,0
2020,Mozambique,0,10,9,0,0,0,0
2020,Myanmar,0,2,2,0,0,0,0
2020,Nauru,0,2,2,0,0,0,0
2020,Nepal,0,5,5,0,0,0,0
2020,Nicaragua,0,8,8,0,0,0,0
2020,Niger,0,7,7,0,0,0,0
2020,Oman,0,5,5,0,0,0,0
2020,Pakistan,0,10,9,0,0,0,0
2020,Palau,0,3,3,0,0,0,0
2020,Palestine,0,5,5,0,0,0,0
2020,Panama,0,10,11,0,0,0,0
2020,Papua New Guinea,0,8,8,0,0,0,0
2020,Paraguay,0,8,9,0,0,0,0
2020,Peru,0,35,35,0,0,0,0
2020,Refugee,0,29,30,0,0,0,0
2020,Republic of Congo,0,3,3,0,0,0,0
2020,Rwanda,0,5,5,0,0,0,0
2020,Saint Kitts,0,2,2,0,0,0,0
2020,Saint Lucia,0,5,5,0,0,0,0
2020,Saint Vincent,0,3,3,0,0,0,0
2020,Samoa,0,8,11,0,0,0,0
2020,Sao Tome and Principe,0,3,3,0,0,0,0
2020,Senegal,0,9,9,0,0,0,0
2020,Seychelles,0,5,6,0,0,0,0
2020,Sierra Leone,0,4,4,0,0,0,0
2020,Singapore,0,23,23,0,0,0,0
2020,Solomon Islands,0,3,3,0,0,0,0
2020,Somalia,0,2,2,0,0,0,0
2020,South Sudan,0,2,2,0,0,0,0
2020,Sri Lanka,0,9,13,0,0,0,0
2020,Sudan,0,5,5,0,0,0,0
2020,Suriname,0,3,5,0,0,0,0
2020,Swaziland,0,4,4,0,0,0,0
2020,Tajikistan,0,10,10,0,0,0,0
2020,Tanzania,0,3,2,0,0,0,0
2020,Timor-Leste,0,3,3,0,0,0,0
2020,Togo,0,4,4,0,0,0,0
2020,Tonga,0,6,6,0,0,0,0
2020,Trinidad,0,33,25,0,0,0,0
2020,United Arab Emirates,0,5,5,0,0,0,0
2020,Uruguay,0,11,9,0,0,0,0
2020,Vanuatu,0,3,3,0,0,0,0
2020,Vietnam,0,18,21,0,0,0,0
2020,"Virgin Islands, British",0,3,3,0,0,0,0
2020,"Virgin Islands, US",0,4,5,0,0,0,0
2020,Yemen,0,5,6,0,0,0,0
2020,Zambia,0,30,10,0,0,0,0
2020,Zimbabwe,0,5,5,0,0,0,0
